border_size=1
usage=map

Hd          , Hd          , Hd          , Hd          , Hd          , Hd          , Hhd         , Hhd^Vhhr    , Hhd         , Hh          , Hh          , Hh^Fms      , Hh^Fms      , Gll^Fmf     , Gll^Fmf     , Gll^Fmf     , Gll^Fmf     , Gll^Fmf     , Gs          , Gll^Fmf     , Gll^Fmf     , Ss          , Ss          , Gll^Fmf     , Gll^Fmf     , Gll^Fmf     , Gs          , Gs          , Gs          , Ss          , Ss          , Ss^Vhs      , Ss          , Ss          , Gs          , Gs          , Gll^Fmf     , Gs          , Gll^Fmf     , Gll^Fmf     , Gll^Fmf     , Gg^Ve       
Hd          , Hd          , Ds          , Hd          , Ds          , Hd          , Hhd         , Hhd         , Hhd         , Hhd         , Hh          , Hh          , Ds          , Ds          , Ds          , Gll^Fmf     , Ds          , Gll^Fmf     , Gll^Fmf     , Gs          , Gll^Fmf     , Gll^Fmf     , Ss          , Gll^Fmf     , Ss          , Gs          , Ss          , Gs          , Ss          , Ss          , Ss          , Ss          , Gs          , Ss          , Gs          , Gs          , Gs          , Gll^Fmf     , Gll^Fmf     , Gll^Fmf     , Gll^Fmf     , Gll^Fmf     
Hd          , Hd          , Ds          , Ds          , Ds          , Ds          , Ds          , Ds          , Ds          , Ds          , Ds          , Ds          , Ds          , Ds          , Ds          , Ds          , Ds          , Ds          , Ds          , Gs          , Ds          , Ds          , Ds          , Ss          , Ds          , Ss          , Gll^Fmf     , Ss          , Ss          , Ss          , Ss          , Gs          , Ss          , Gs          , Gs          , Gs          , Gs          , Gll^Fmf     , Gs          , Gll^Fmf     , Gll^Fmf     , Gs          
Hd          , Ds          , Ds          , Dd^Vda      , Ds          , Ds          , Ds          , Ds          , Dd^Dc       , Ds          , Gs          , Gs          , Gs          , Gs          , Ds          , Ds          , Ds          , Dd^Vda      , Ds          , Gs          , Gs          , Ds          , Ds          , Ds          , Ds          , Gll^Fmf     , Gll^Fmf     , Gll^Fmf     , Ss          , Ss          , Gs          , Gs          , Ss          , Gs          , Ss          , Ss          , Ss          , Gs          , Gs          , Gll^Fmf     , Gs          , Gs          
Hd          , Hd          , Ds          , Ds          , Dd^Do       , Ds          , Cd          , Ds          , Ds          , Ds          , Gs          , Ss          , Ss          , Gs          , Gs          , Gs          , Ds          , Ds          , Ds          , Ds          , Gs          , Gs          , Ds          , Ds          , Dd^Vda      , Ds          , Gll^Fmf     , Gll^Fmf     , Ss          , Ss          , Ss          , Gs          , Ss          , Ss          , Ss          , Ss^Vhs      , Ss          , Gs          , Gs          , Gs          , Gs          , Gs          
Ds          , Ds          , Dd^Dc       , Ds          , Ds          , Ds          , 2 Kd        , Ds          , Dd^Vda      , Gs          , Gs          , Ss          , Chw         , Ss          , Ss          , Gs          , Gs          , Gs          , Gs          , Gs          , Gs          , Ds          , Gll^Fmf     , Ds          , Ds          , Ds          , Gll^Fmf     , Gll^Fmf     , Ss          , Gs          , Gs          , Ss          , Ss          , Ss          , Gs          , Ss          , Ss          , Gs          , Wwt         , Wwt         , Wwt         , Wwt         
Ds          , Ds          , Ds          , Ds          , Wwt         , Chw         , Chw         , Rd          , Ds          , Gs^Ft       , Rd          , 3 Kd        , Chw         , Wwt         , Ss          , Gs          , Ds          , Ds          , Ds          , Gll^Fmf     , Gll^Fmf     , Gll^Fmf     , Ss          , Gll^Fmf     , Ss          , Ss          , Ss          , Ss          , Gs          , Gs          , Gll^Fmf     , Gll^Fmf     , Gll^Fmf     , Ss          , Ss          , Gs          , Gs          , Gs          , Wwt         , Wwt         , Wwt         , Wwt         
Ds          , Dd^Vdt      , Ds          , Ss          , Wwt         , Ss          , Rd          , Rd          , Gs^Ft       , Gs^Ft       , Rd          , Cd          , Ss          , Wwt         , Ss          , Ds          , Ds          , Dd^Dr       , Ds          , Ds          , Ss          , Ss          , Gs          , Ss          , Ss          , Gll^Fmf     , Gll^Fmf     , Ss          , Gll^Fmf     , Gll^Fmf     , Gll^Fmf     , Gll^Fmf     , Gll^Fmf     , Ss          , Ss          , Gs          , Wwt         , Wwt         , Wwt         , Wwt         , Wwt         , Wwt         
Ds          , Ds          , Ss          , Ss          , Wwt         , Ss          , Ss^Bw/      , Rd          , Rd          , Gs^Ft       , Rd          , Ss          , Wwt^Bw\     , Wwt         , Wwt         , Ss          , Ds          , Ds          , Ss          , Gll^Fmf     , Ss          , Gs          , Ds          , Gs          , Gs          , Gll^Fmf     , Gs          , Gll^Fmf     , Gll^Fmf     , Gll^Fmf     , Ss          , Ss          , Ss          , Ss          , Wwt         , Wwt         , Wwt         , Wwt         , Wwt         , Wwt         , Wwt         , Wwt         
Gs^Ft       , Gs^Ft       , Ss          , Ss          , Wwt         , Wwt         , Wwt         , Ss^Bw/      , Ss^Bw/      , Rd          , Wwt^Bw\     , Wwt^Bw\     , Wwt         , Wwt         , Wwt         , Ss          , Ss          , Ds          , Wwt         , Ss          , Ds          , Ds          , Dd^Vdt      , Ds          , Ds          , Gs          , Ss          , Ss          , Ss          , Ss          , Ss          , Wwt         , Wwt         , Wwt         , Wwt         , Wwt         , Wwt         , Wwt         , Wwt         , Wwt         , Wwt         , Wwt         
Gs^Ft       , Gs^Ft       , Ss^Vhs      , Ss          , Ss          , Wwt         , Wwt         , Wwt         , Ss          , Ss          , Wwt         , Wwt         , Wwt         , Wwt         , Ss          , Ss          , Ss          , Ds          , Ss          , Ss          , Ds          , Ds          , Ds          , Ds          , Ss          , Ss          , Ss          , Ss          , Wwt         , Ss          , Wwt         , Wwt         , Wwt         , Wwt         , Wwt         , Wwt         , Wwt         , 1 Wwt       , Wwt         , Wwt         , Wot         , Wwt         
Gs^Ft       , Gs^Ft       , Gs^Ft       , Gs^Ft       , Gs^Ft       , Gs^Ft       , Wwt         , Wwt         , Gs^Ft       , Gs^Ft       , Gs^Ft       , Wwt         , Wwt         , Ss          , Gs^Ft       , Ss^Vhs      , Gs^Ft       , Gs^Ft       , Wwt         , Ss          , Ss          , Ss          , Ss          , Ss          , Wwt         , Ss          , Wwt         , Wwt         , Wwt         , Wwt         , Wwt         , Wwt         , Wwt         , Wwt         , Wwt         , Wwt         , Wot         , Wwt         , Wwt         , Wot         , Wot         , Wot         
Ss          , Gs^Ft       , Ss          , Gs^Ft       , Wwt         , Wwt         , Ss          , Gs^Ft       , Ss          , Gs^Ft       , Ss          , Wwt         , Wwt         , Gs^Ft       , Wwt         , Gs^Ft       , Wwt         , Wwt         , Wwt         , Wwt         , Wwt         , Wwt         , Wwt         , Wwt         , Wwt         , Wwt         , Wwt         , Wwt         , Wwt         , Wwt         , Wwt         , Wwt         , Wwt         , Wwt         , Wot         , Wwt         , Wot         , Wot         , Wwt         , Wwt         , Wwt         , Wwt         
Ss          , Ss          , Wwt         , Ss          , Wwt         , Wwt         , Wwt         , Wwt         , Wwt         , Wwt         , Wwt         , Wwt         , Wwt         , Wwt         , Wot         , Wwt         , Wwt         , Wot         , Wwt         , Wot         , Wot         , Wwt         , Wot         , Wwt         , Wwt         , Wwt         , Wot         , Wwt         , Wot         , Wwt         , Wot         , Wwt         , Wot         , Wot         , Wot         , Wot         , Wwt         , Wwt         , Wwt         , Wwt         , Wwt         , Wwt         
Wwt         , Wwt         , Wwt         , Wwt         , Wwt         , Wwt         , Wwt         , Wwt         , Wwr         , Wwt         , Wwr         , Wwt         , Wwr         , Wwt         , Wwt         , Wwt         , Wwr         , Wwt         , Wwr         , Wwt         , Wot         , Wot         , Wot         , Wot         , Wwt         , Wwt         , Wot         , Wot         , Wot         , Wot         , Wwt         , Wwt         , Wwt         , Wwt         , Wwt         , Wwt         , Wwt         , Wwt         , Ds          , Wwt         , Ds          , Ds          
Wwt         , Wot         , Wot         , Wwt         , Wwr         , Wwr         , Wwt         , Wwt         , Wwr         , Wwr         , Wwr         , Wwr         , Wwt         , Wwt         , Wwr         , Wwr         , Wwr         , Wwr         , Wwr         , Wwt         , Wot         , Wot         , Wwt         , Wot         , Wwt         , Wwt         , Wwt         , Wwt         , Wwt         , Wwt         , Wwt         , Wwt         , Wwt         , Wwt         , Wwt         , Wwt         , Wwt         , Ds          , Ds          , Ds          , Ds          , Ds          
Wot         , Wot         , Wwt         , Wwt         , Wwr         , Wwr         , Wwt         , Wwr         , Wwt         , Wwt         , Wwt         , Wwt         , Wot         , Wwt         , Wwt         , Wwt         , Wwt         , Wwt         , Wwt         , Wwt         , Wwt         , Wwt         , Wwt         , Wwt         , Wwt         , Wwt         , Wwt         , Wwt         , Wwt         , Wwt         , Wwt         , Wwt         , Wwt         , Wwt         , Wwt         , Wwt         , Ds          , Ds          , Ds          , Dd^Vdt      , Ds          , Ds          
Wot         , Wot         , Wwt         , Wwr         , Wwt         , Wwr         , Wwt         , Wwt         , Wot         , Wot         , Wot         , Wot         , Wwt         , Wot         , Wot         , Wot         , Wwt         , Wwt         , Wwt         , Ww^Vm       , Wwt         , Wwt         , Wwt         , Wwt         , Wwt         , Wwt         , Wwt         , Wwt         , Wwt         , Wwt         , Ds          , Wwt         , Ds          , Ds          , Ds          , Ds          , Ds          , Ds          , Ds          , Ds          , Ds          , Ds          
Wot         , Wot         , Wot         , Wwt         , Wwt         , Wwt         , Wwt         , Wot         , Wwt         , Wot         , Wwt         , Wwt         , Wwt         , Wwt         , Wwt         , Wwt         , Wwt         , Wwt         , Wwt         , Wwt         , Wwt         , Wwt         , Wwt         , Wwt         , Ds          , Wwt         , Ds          , Ds          , Ds          , Ds          , Ds          , Ds          , Ds          , Ds          , Ds          , Ds          , Ds          , Ds          , Gs^Ft       , Ds          , Ss          , Ss          
Wwt         , Wot         , Wwt         , Wwt         , Ww^Vm       , Wwt         , Wwt         , Wwt         , Wwt         , Wwt         , Wwt         , Wwt         , Wwt         , Wwt         , Wwt         , Wwt         , Ds          , Wwt         , Ds          , Ds          , Ds          , Ds          , Ds          , Ds          , Ds          , Ds          , Ds          , Ds          , Ds          , Ds          , Ds          , Ds          , Ds          , Ds          , Gs^Ft       , Gs^Ft       , Gs^Ft       , Gs^Ft       , Gs^Ft       , Ss          , Ss          , Ss          
Wwt         , Wwt         , Wwt         , Wwt         , Wwt         , Wwt         , Wwt         , Wwt         , Wwt         , Wwt         , Wwt         , Wwt         , Wwt         , Wwt         , Ds          , Ds          , Ds          , Ds          , Gs^Ft       , Ds          , Gs^Ft       , Ds          , Gs^Ft       , Ds          , Gs^Ft       , Ds          , Gs^Ft       , Ds          , Gs^Ft       , Gs^Ft       , Gs^Ft       , Gs^Ft       , Gs^Ft       , Gs^Ft       , Gs^Ft       , Gs^Ft       , Ss          , Ss          , Ss          , Ss          , Ss          , Ss          
Wwt         , Wwt         , Wwt         , Wwt         , Wwt         , Wwt         , Wwt         , Wwt         , Ds          , Ds          , Ds          , Ds          , Ds          , Ds          , Gs^Ft       , Gs^Ft       , Gs^Ft       , Gs^Ft       , Gs^Ft       , Gs^Ft       , Gs^Ft       , Gs^Ft       , Gs^Ft       , Gs^Ft       , Gs^Ft       , Gs^Ft       , Gs^Ft       , Gs^Ft       , Gs^Ft       , Gs^Ft       , Gs^Ft       , Gs^Ft       , Gs^Ft       , Ss          , Ss          , Ss          , Ss          , Ss          , Ss          , Ss          , Ss          , Gs^Ft       
