border_size=1
usage=map

Wot         , Wot         , Wwt         , Wot         , Wot         , Wot         , Wwt         , Wot         , Wot         , Wot         , Wot         , Wot         , Wot         , Wot         , Wot         , Wot         , Wot         , Wot         , Wot         , Wot         , Wot         , Wot         , Wot         , Wot         , Wot         , Wot         , Wot         , Wot         , Wot         , Wot         , Wot         , Wot         , Wot         , Wot         , Wot         , Wot         , Wot         , Wot         , Wot         , Wot         , Wot         
Wot         , Wot         , Wwt         , Wwt         , Wwt         , Wwt         , Wwt         , Wwt         , Wot         , Wot         , Wot         , Wot         , Wot         , Wot         , Wwt         , Wot         , Wot         , Wot         , Wot         , Wot         , Wot         , Wot         , Wwt         , Wot         , Wot         , Wot         , Wot         , Wot         , Wot         , Wot         , Wot         , Wot         , Wwt         , Wot         , Wot         , Wot         , Wot         , Wot         , Wot         , Wot         , Wot         
Wot         , Wwt         , Gs^Ft       , Gs^Ft       , Gs^Ft       , Gs^Ft       , Wwt         , Wwt         , Wwt         , Wwt         , Wwt         , Wot         , Wwt         , Wwt         , Ww^Vm       , Wwt         , Wot         , Wot         , Wot         , Wot         , Wwt         , Wwt         , Wwt         , Wwt         , Wwt         , Wot         , Wwt         , Wot         , Wwt         , Wot         , Wot         , Wwt         , Wwt         , Wwt         , Wwt         , Wot         , Wot         , Wot         , Wot         , Wot         , Wot         
Wot         , Wwt         , Gs^Ft       , Ds^Edp      , Ds          , Ds          , Ds          , Wwt         , Wwt         , Wwt         , Wwt         , Wwt         , Wwt         , Wwt         , Wwt         , Wwt         , Wot         , Wot         , Wot         , Wot         , Wwt         , Wwt         , Ds          , Wwt         , Wwt         , Wwt         , Wwt         , Wwt         , Wwt         , Wwt         , Wwt         , Wwt         , Wwt         , Ds          , Ds          , Wwt^Bw/     , Wwt         , Wot         , Wot         , Wot         , Wot         
Wot         , Wwt         , Ds          , Ds          , Ds          , Dd^Vdt      , Ds          , Gs^Ft       , Wwt         , Wwt         , Wot         , Wot         , Wot         , Wot         , Wot         , Wot         , Wot         , Wot         , Wot         , Wwt         , Wwt         , Wwt         , Ds          , Ds          , Ds          , Ds          , Ds          , Ds          , Ds          , Wwt         , Ds          , Wwt         , Ds          , Ds          , Ce          , Ds          , Ds          , Wwt         , Wot         , Wot         , Wot         
Wot         , Wwt         , Ds          , Dd^Vdt      , Ds          , Ds          , Gs^Ft       , Gs^Ft       , Wwt         , Wwt         , Wot         , Wot         , Wot         , Wot         , Wot         , Wot         , Wot         , Wot         , Wwt         , Wwt         , Wwt         , Ds          , Ds          , Ds          , Dd^Vdt      , Ds          , Ds          , Ds          , Ds          , Ds          , Ds          , Wwt         , Ds          , Ce          , 3 Ke        , Ce          , Ds          , Wwt         , Wwt         , Wot         , Wot         
Wot         , Wwt         , Wwt         , Ds          , Gs^Ft       , Gs^Ft       , Gs^Ft       , Wwt         , Wwt         , Wot         , Wot         , Wot         , Wwrt        , Wot         , Wot         , Wot         , Wot         , Wot         , Wwt         , Wwt         , Ds          , Ds          , Ds          , Ds          , Ds          , Ds          , Wwt         , Ds          , Ds          , Dd^Vdt      , Ds          , Ds          , Ds          , Ce          , Ce          , Ce          , Ds          , Wwt         , Wwt         , Wot         , Wot         
Wot         , Wot         , Wot         , Wwt         , Wwt         , Wwt         , Wwt         , Wwt         , Wot         , Wot         , Wot         , Wot         , Wwrt        , Wwrt        , Wot         , Wot         , Wot         , Wwt         , Wwt         , Ds          , Ds          , Wwt         , Wwt         , Wwt         , Wwt         , Wwt         , Wwt         , Ds          , Ds          , Ds          , Rd          , Rd          , Rd          , Ds          , Ds          , Ds          , Ds          , Wwt         , Wot         , Wot         , Wot         
Wot         , Wot         , Wot         , Wwt         , Wwt         , Wot         , Wot         , Wot         , Wot         , Wot         , Wot         , Wwrt        , Wot         , Wwrt        , Wot         , Wot         , Wot         , Wwt         , Wwt         , Wwt         , Wwt         , Wwt         , Wwrt        , Wwrt        , Wwrt        , Wwrt        , Wwt         , Ds          , Wwrt        , Ds          , Ds          , Rd          , Ds          , Ds          , Wwt         , Wwt         , Wwt         , Wwt         , Wot         , Wot         , Wot         
Wot         , Wot         , Wot         , Wot         , Wwt         , Wwt         , Wot         , Wot         , Wot         , Wot         , Wot         , Wot         , Wot         , Wot         , Wot         , Wot         , Wot         , Wot         , Wot         , Wwt         , Wwt         , Wwt         , Wwt         , Wwrt        , Wwt         , Wwt         , Wwt         , Wwt         , Wwrt        , Wwrt        , Ds          , Ds          , Ds          , Wwt         , Wwrt        , Wwrt        , Wwt         , Wot         , Wot         , Wot         , Wot         
Wot         , Wot         , Wot         , Wwt         , Ww^Vm       , Wwt         , Wwt         , Wot         , Wot         , Wot         , Wot         , Wot         , Wot         , Chw         , Wot         , Wot         , Wot         , Chw         , Wwt         , Wwt         , Wwt         , Chw         , Wwt         , Wwrt        , Wwt         , Chw         , Wwt         , Wwrt        , Wwt         , Wwrt        , Wwrt        , Wwrt        , Wwt         , Wwt         , Wwt         , Wwrt        , Wwt         , Wwt         , Wot         , Wot         , Wot         
Wot         , Wot         , Wot         , Wwt         , Wwt         , Wwt         , Wwt         , Wot         , Wot         , Wot         , Chw         , Wot         , Wot         , Wot         , Wot         , Wwt         , Wot         , Wot         , Wwt         , Wwrt        , Wwt         , Wwt         , Ds          , Wwt         , Ds          , Wwt         , Wwt         , Wwt         , Chw         , Wwt         , Wwt         , Wwt         , Wwt         , Wwt         , Wot         , Wwt         , Wot         , Wot         , Wot         , Wot         , Wot         
Wot         , Wot         , Wot         , Wot         , Wwt         , Wwt         , Wwt         , Wwt         , Wwt         , Wwt         , Wwt         , Wot         , Wwt         , Wwt         , Wwt         , Wwt         , Wwt         , Wwt         , Wwrt        , Wwrt        , Wwrt        , Wwt         , Ds          , Ds          , Hd          , Ds          , Ds          , Wwt         , Wwt         , Wwt         , Wot         , Wot         , Wot         , Wot         , Wot         , Wwt         , Wot         , Wot         , Wot         , Wot         , Wot         
Wot         , Wot         , Wot         , Wot         , Wot         , Wwt         , Wwt         , Chw         , Wwt         , Ds          , Ds          , Wwt         , Wwt         , Wwrt        , Wwt         , Wwt         , Wwt         , Wwt         , Wwt         , Wwrt        , Wwt         , Wwt         , Wwt         , Ds          , Ds          , Hd          , Ds          , Wwt         , Wwt         , Wot         , Wot         , Chw         , Wot         , Wot         , Wot         , Wot         , Wot         , Wot         , Wot         , Wot         , Wot         
Wot         , Wot         , Wot         , Wot         , Wot         , Wwt         , Wwt         , Wwt         , Ds          , Dd^Vht      , Ds          , Wwt         , Ds          , Ds          , Ds          , Ds          , Wwt         , Ds          , Wwt         , Wwt         , Wwt         , Ds          , Wwt         , Ds          , Ds          , Hd          , Ds          , Wwt         , Wwt         , Wot         , Wot         , Wot         , Wot         , Wot         , Wot         , Wot         , Wot         , Wot         , Wot         , Wot         , Wot         
Wot         , Wot         , Wot         , Wot         , Wot         , Wwt         , Wwt         , Wwt         , Wwt         , Ds          , Wwt         , Wwt         , Ds          , Hd          , Hd          , Ds          , Ds          , Wwt         , Chw         , Chw         , Chw         , Wwt         , Wot         , Wwt         , Wwt         , Ds          , Ds          , Ds          , Wwt         , Wwt         , Wot         , Wot         , Wot         , Wot         , Wot         , Wot         , Wot         , Wot         , Wot         , Wot         , Wot         
Wot         , Wot         , Wot         , Wot         , Wot         , Wot         , Wwt         , Chw         , Wwt         , Wwt         , Wwrt        , Ds          , Hd          , Ds          , Ds          , Ds          , Wwt         , Wwt         , Chw         , 2 Khw       , Chw         , Wwt         , Wwt         , Wwt         , Ds          , Ds          , Ce          , Ds          , Wwt         , Wwt         , Wot         , Chw         , Wot         , Wot         , Wot         , Wot         , Wwt         , Wot         , Wot         , Wot         , Wot         
Wot         , Wot         , Wot         , Wot         , Wot         , Wot         , Wwt         , Wwt         , Wwt         , Wwt         , Wwrt        , Ds          , Hd          , Ds          , Ds^Edpp     , Ds          , Ds          , Wwt         , Wwt         , Chw         , Wwt         , Wwt         , Wwt         , Ds          , Ds          , Ce          , 1 Ke        , Chw         , Wwt         , Wot         , Wot         , Wot         , Wot         , Wot         , Wot         , Wot         , Wwt         , Wwt         , Wot         , Wot         , Wot         
Wot         , Wot         , Ww^Vm       , Wot         , Wot         , Wwt         , Wwrt        , Wwrt        , Wwrt        , Wwrt        , Ds          , Ds          , Ds          , Ds          , Ds          , Ds          , Wwrt        , Wwt         , Wot         , Wwt         , Ds          , Ds          , Ds          , Wo          , Ds          , Ce          , Ww^Vm       , Chw         , Wot         , Wot         , Wot         , Wot         , Wot         , Wot         , Wot         , Wot         , Wwt         , Ww^Vm       , Wwt         , Wot         , Wot         
Wot         , Wot         , Wot         , Wwt         , Wot         , Wwt         , Wwrt        , Chw         , Wwrt        , Wwrt        , Wwrt        , Ds          , Wwrt        , Ds          , Wwrt        , Wwrt        , Wwt         , Wwt         , Wot         , Wwt         , Ds          , Dd^Vda      , Ds          , Wwt         , Wwt         , Ds          , Wwt         , Wwt         , Wot         , Wot         , Wot         , Chw         , Wot         , Wot         , Wot         , Wot         , Wot         , Wot         , Wot         , Wot         , Wot         
Wot         , Wot         , Wot         , Wot         , Wot         , Wwt         , Wwt         , Wwrt        , Wwrt        , Wwrt        , Chw         , Wwrt        , Wwrt        , Ds          , Wwrt        , Wwrt        , Wwt         , Wot         , Wot         , Wwt         , Wwt         , Ds          , Wwt         , Wwt         , Wot         , Wwt         , Wot         , Wot         , Chw         , Wot         , Wot         , Wot         , Wot         , Wot         , Wot         , Wot         , Wot         , Wot         , Wot         , Wot         , Wot         
Wot         , Wot         , Wot         , Wot         , Wot         , Wot         , Wwt         , Wwrt        , Wwrt        , Wwrt        , Wwrt        , Wwrt        , Wwrt        , Wwrt        , Wwrt        , Wwt         , Wwt         , Wwt         , Wwt         , Wot         , Wot         , Wwt         , Wot         , Wot         , Wot         , Wot         , Wot         , Wot         , Wot         , Wot         , Wot         , Wot         , Wot         , Wot         , Wot         , Wot         , Wot         , Wot         , Wot         , Wot         , Wot         
Wot         , Wot         , Wot         , Wot         , Wwt         , Wwt         , Wwt         , Wwrt        , Wwrt        , Wwrt        , Wwrt        , Wwrt        , Wwrt        , Chw         , Wwrt        , Wwt         , Wwt         , Chw         , Wwt         , Wot         , Wot         , Chw         , Wot         , Wot         , Wot         , Chw         , Wot         , Wot         , Wot         , Wot         , Wot         , Wot         , Wot         , Wot         , Wot         , Wot         , Wot         , Wot         , Wot         , Wot         , Wot         
Wot         , Wot         , Wot         , Wwt         , Gs^Ft       , Wwt         , Gs^Ft       , Wwt         , Wwrt        , Wwrt        , Wwt         , Wwrt        , Wwt         , Wwrt        , Wwt         , Wwt         , Wot         , Wwt         , Wot         , Wot         , Wot         , Wot         , Wot         , Wot         , Wot         , Wot         , Wot         , Wot         , Wot         , Wot         , Wot         , Wot         , Wot         , Wot         , Wot         , Wot         , Wot         , Wot         , Wot         , Wot         , Wot         
Wot         , Wot         , Wwt         , Wwt         , Gs^Ft       , Gs^Ft       , Gs^Ft       , Wwt         , Wwt         , Wwrt        , Wwrt        , Wwt         , Wot         , Wwt         , Wot         , Wot         , Wot         , Wot         , Wot         , Wot         , Wot         , Wot         , Wot         , Wot         , Wot         , Wot         , Wot         , Wot         , Wot         , Wot         , Wot         , Wot         , Wwt         , Wot         , Wwt         , Wwt         , Wwt         , Wot         , Wot         , Wot         , Wot         
Wot         , Wot         , Wwt         , Gs^Ft       , Hd          , Ds^Vht      , Ds          , Ds          , Wwt         , Wwrt        , Wwt         , Wwt         , Wot         , Wot         , Wot         , Wot         , Wot         , Wot         , Wot         , Wot         , Wot         , Wot         , Wot         , Wot         , Wot         , Wot         , Wot         , Wot         , Wot         , Wot         , Wot         , Wwt         , Ds          , Wwt         , Ds          , Ds          , Wwt         , Wot         , Wot         , Wot         , Wot         
Wot         , Wot         , Wwt         , Ds          , Ds          , Ds          , Ds^Esd      , Ds          , Ds          , Wwt         , Wwt         , Wot         , Wot         , Wot         , Wot         , Wot         , Wwt         , Wwt         , Ww^Vm       , Wwt         , Wot         , Wot         , Wot         , Wot         , Wot         , Wot         , Wot         , Wot         , Wwt         , Wwt         , Wwrt        , Wwrt        , Ds          , Ds          , Ds          , Ds          , Ds          , Wwt         , Wot         , Wot         , Wot         
Wot         , Wot         , Wwt         , Ds          , Ds          , Ds          , 4 Ds^Edp    , Ds          , Ds          , Wwt         , Wwt         , Wot         , Wot         , Wot         , Wot         , Wot         , Wot         , Wwt         , Wwt         , Wot         , Wot         , Wot         , Wot         , Wot         , Wot         , Wot         , Wwt         , Wwt         , Ds          , Ds          , Ds          , Wwrt        , Ds          , Dd^Vht      , Ds          , Dd^Vht      , Ds          , Wwt         , Wot         , Wot         , Wot         
Wot         , Wot         , Wot         , Wwt         , Ds          , Ds          , Ds          , Ds          , Ds          , Ds          , Wwt         , Wwt         , Wot         , Wot         , Wot         , Wot         , Wot         , Wwt         , Wot         , Wwt         , Wot         , Wot         , Wot         , Wot         , Wot         , Wot         , Wwt         , Ds          , Ds          , Dd^Vdt      , Ds          , Ds          , Ds          , Ds          , Ds          , Ds          , Wwt         , Wwt         , Wot         , Wot         , Wot         
Wot         , Wot         , Wot         , Wwt         , Ds          , Ds          , Ds          , Ds          , Wwt         , Wwt^Bw\     , Wwt         , Wot         , Wot         , Wot         , Wot         , Wot         , Wot         , Wot         , Wot         , Wot         , Wot         , Wot         , Wot         , Wot         , Wot         , Wwrt        , Wwrt        , Wwt         , Wwt         , Ds          , Wwt         , Wwt         , Wwt         , Wwt         , Wwt         , Ds          , Wwt         , Wot         , Wot         , Wot         , Wot         
Wot         , Wot         , Wot         , Wwt         , Wwt         , Wwt         , Wwt         , Wwt         , Wot         , Wwt         , Wot         , Wot         , Wot         , Wot         , Wot         , Wot         , Wot         , Wot         , Wot         , Wot         , Wot         , Wot         , Wot         , Wot         , Wot         , Wot         , Wot         , Wot         , Wot         , Wwt         , Wwt         , Wot         , Wot         , Wot         , Wot         , Wwt         , Wot         , Wot         , Wot         , Wot         , Wot         
Wot         , Wot         , Wot         , Wot         , Wot         , Wot         , Wot         , Wot         , Wot         , Wot         , Wot         , Wot         , Wot         , Wot         , Wot         , Wot         , Wot         , Wot         , Wot         , Wot         , Wot         , Wot         , Wot         , Wot         , Wot         , Wot         , Wot         , Wot         , Wot         , Wot         , Wot         , Wot         , Wot         , Wot         , Wot         , Wot         , Wot         , Wot         , Wot         , Wot         , Wot         
Wot         , Wot         , Wot         , Wot         , Wot         , Wot         , Wot         , Wot         , Wot         , Wot         , Wot         , Wot         , Wot         , Wot         , Wot         , Wot         , Wot         , Wot         , Wot         , Wot         , Wot         , Wot         , Wot         , Wot         , Wot         , Wot         , Wot         , Wot         , Wot         , Wot         , Wot         , Wot         , Wot         , Wot         , Wot         , Wot         , Wot         , Wot         , Wot         , Wot         , Wot         
