border_size=1
usage=map

Wwt         , Wwt         , Wwt         , Wwt         , Wwt         , Wwt         , Ss          , Gs^Ft       , Gs^Ft       , Gs^Ft       , Gs^Ft       , Gs^Ft       , Ss          , Gs^Ft       , Gs^Ft       , Gs^Ft       , Gs^Ft       , Gs^Ft       , Ds          , Ds          , Rd          , Rd          , Ds          , Ds          , Gs^Ft       , Gs^Ft       , Ss          , Ss          , Ss          , Gs          , Gs          , Gg          , Gs          , Gg          , Gs          , Ss          , Ss          , Gs^Ft       , Ss          , Gs^Ft       , Gs^Ft       , Gs^Ft       
Wot         , Wwt         , Wot         , Wwt         , Wwt         , Wwt         , Wwt         , Ss          , Ss          , Ss          , Ss          , Gs^Ft       , Ss          , Ss          , Ds          , Ds          , Ds          , Ds          , Ds          , Ds          , Rd          , Ds          , Ds          , Ds          , Ds          , Gs^Ft       , Gs^Ft       , Ss          , Ss          , Ss          , Gs          , Gs          , Gg          , Gs          , Gs          , Gs          , Gs          , Ss          , Gg          , Ss          , Ss          , Gs^Ft       
Wwt         , Wot         , 1 Wwt       , Wot         , Wot         , Wwt         , Wot         , Wwt         , Wwt         , Wwt         , Wwt         , Ss          , Wwt         , Ss          , Ds          , Ds          , Ds          , Ds          , Rd          , Rd          , Ds          , Ds          , Ds          , Ds          , Ds          , Gs^Ft       , Gs^Ft       , Gs^Ft       , Gs^Ft       , Ss          , Ss          , Gs          , Gs          , Ss          , Ss          , Gs          , Gg          , Gs          , Gs          , Gg          , Ss^Vhs      , Gd          
Wwt         , Wwt         , Wwt         , Wot         , Wwt         , Wot         , Wot         , Wwt         , Wwt         , Wwt         , Wwt         , Wwt         , Wwt         , Wwt         , Wwt         , Ds          , Ds          , Ds          , Ds          , Ds          , Ds          , Dd^Vdt      , Ds          , Ds          , Gs^Ft       , Gs^Ft       , Gs^Ft       , Gs^Ft       , Gs^Ft       , Ss          , Ss          , Ss          , Ss          , Gs          , Gs          , Ss          , Ss          , Gs          , Gg          , Gg          , Gd          , Gd          
Ds          , Wwt         , Wwt         , Wwt         , Wwt         , Wwt         , Wot         , Wot         , Wot         , Wwt         , Wot         , Wwt         , Wot         , Wwt         , Wwt^Bw/     , Wwt         , Wwt         , Wwt         , Wwt         , Wwt         , Wwt         , Ds          , Ds          , Ds          , Ss          , Gs^Ft       , Gs^Ft       , Gs^Ft       , Gs^Ft       , Gs^Ft       , Ss          , Ss          , Ss          , Gs          , Gs          , Chs         , 2 Ke        , Ss          , Gs          , Gs          , Gd          , Gs          
Ds          , Wwt         , Wwt         , Wwt         , Wwt         , Wwt         , Wwt         , Wwt         , Wwt         , Wot         , Wot         , Wot         , Wot         , Wwt         , Wwt         , Wwt         , Wwt         , Wwt         , Wwt         , Wwt         , Wwt         , Wwt         , Wwt         , Ss          , Wwt         , Ss          , Wwt         , Ss          , Wwt         , Ss          , Ss          , Ss          , Ss^Vhs      , Ss          , Gs          , Ce          , Ce          , Ce          , Gd          , Gd          , Gs          , Gs          
Ds          , Ds          , Ds          , Wwt         , Ds          , Wwt         , Wwt         , Wwt         , Wwt         , Wwt         , Wwt^Bw/     , Wwt         , Wot         , Wot         , Wot         , Wwt         , Wot         , Wot         , Wwt         , Wwt         , Wwt         , Wwt         , Wwt         , Wwt         , Wwt         , Wwt         , Wwt         , Wwt         , Wwt         , Wwt         , Wwt         , Ss          , Ss          , Ss          , Gs          , Gs          , Gs          , Gs          , Gd          , Gs          , Cv          , Gs          
Ds          , Ds          , Dd^Vdt      , Ds          , Ds          , Ds          , Ds          , Wwt         , Wwt         , Wwt         , Wwt         , Wwt         , Wwt         , Wwt         , Wot         , Wot         , Wot         , Wot         , Wot         , Wot         , Wot         , Wwt         , Wot         , Wot         , Wot         , Wwt         , Wot         , Wwt         , Wot         , Wwt         , Wwt         , Wwt         , Wwt         , Ss          , Ss          , Gs          , Gs          , Gd          , Gs          , Gs          , Gs          , Gs          
Gs^Ft       , Ds          , Ds          , Ds          , Ds          , Ss          , Ss          , Ds          , Ss          , Ss          , Ss          , Wwt         , Wwt         , Wwt         , Wwt         , Wwt         , Wwt         , Wwt         , Wwt         , Wot         , Wot         , Wot         , Wot         , Wwt         , Wwt         , Wot         , Wwt         , Wot         , Wot         , Wwt         , Wwt         , Wwt         , Wwt         , Wwt         , Wwt         , Ss          , Wwt^Bsb/    , Gd          , Ss          , Gs          , Gs          , Gs          
Gs^Ft       , Gs^Ft       , Ss          , Gs^Ft       , Ss          , Ss          , Ds          , Ss          , Ds          , Ss          , Gs^Ft       , Gs^Ft       , Wwt         , Wwt         , Ds          , Wwt         , Wwt         , Wwt         , Wwt         , Wwt         , Wwt         , Wot         , Wwt         , Wwt         , Wwt         , Wwt         , Wwt         , Wwt         , Wot         , Wot         , Wot         , Wot         , Wot         , Wwt         , Wwt^Bsb/    , Wwt^Bsb/    , Wwt         , Ss          , Wwt         , Ss          , Ss          , Gs          
Ss          , Ss          , Ss          , Ss          , Gs^Ft       , Gs^Ft       , Gs^Ft       , Ds          , Ds          , Ds          , Ss          , Ss          , Wwt         , Ds          , Ds          , Ds          , Ss          , Ss          , Ss          , Wwt         , Wwt         , Wwt         , Wwt         , Wwt         , Wwf         , Wwt         , Wwt         , Wwt         , Wwt         , Wwt         , Wwt         , Wot         , Wot^Bsb/    , Wwt^Bsb/    , Wwt         , Wwt         , Wwt         , Wwt         , Wwt         , Wwt         , Wwt         , Ss          
Gll^Fp      , Ss          , Gll^Fp      , Ss          , Gll^Fp      , Gs^Ft       , Gs^Ft       , Gs^Ft       , Ss          , Gs^Ft       , Gs^Ft       , Ss          , Wwt         , Ds          , Ds          , Ds          , Ds          , Ss^Vhs      , Ss          , Wwt         , Wwt         , Wwt         , Ds          , Wwf         , Ds          , Wwf         , Ds          , Wwt         , Ds          , Wwt         , Wwt^Bsb/    , Wot^Bsb/    , Wwt         , Wot         , Wot         , Wot         , Wot         , Wot         , Wot         , Wwt         , Wwt         , Wwt         
Gll^Fp      , Ss          , Gll^Fp      , Gll^Fp      , Gll^Fp      , Gll^Fp      , Gs^Ft       , Ss          , Gs^Ft       , Ss          , Ss          , Ss          , Gs^Ft       , Wwt         , Wwt         , Ss          , Ds          , Ss          , Ss          , Wwt         , Wwt         , Wwt         , Ds          , Ds          , Dd^Vdt      , Ds          , Ds          , Ds          , Rd          , Rd          , Ds          , Wwt         , Wwt         , Wwt         , Wwt         , Wwt         , Wwt         , Wot         , Wot         , Wot         , Wot         , Wwt         
Ds          , Gll^Fp      , Ds          , Gll^Fp      , Gll^Fp      , Gll^Fp      , Gs^Ft       , Gs^Ft       , Ds          , Gs^Ft       , Ss          , Gs^Ft       , Gs^Ft       , Gs^Ft       , Wwt         , Gs^Ft       , Gs^Ft       , Ss          , Wwt         , Wwt         , Ds          , Ds          , Ds          , Ds          , Ds          , Ds          , Ds          , Rd          , Ds          , Ds          , Ds          , Ds          , Wwt         , Wwt         , Wwt         , Wwt         , Wwt         , Wwt         , Wwt         , Wwt         , Wwt         , Wot         
Ds          , Ds          , Dd^Dc       , Ds          , Ds          , Ds          , Ds          , Ds          , Ds          , Ds          , Ss          , Ss          , Ss          , Wwf         , Gs^Ft       , Wwt         , Wwt         , Ss          , Wwt         , Gs^Ft       , Ds          , Rd          , Rd          , Ds          , Rd          , Ds          , Ds          , Rd          , Ds          , Ds          , Ds          , Ds          , Ds          , Ds          , Ds          , Wwt         , Wwt         , Wwt         , Wwt         , Wwt         , Wwt         , Wwt         
Ds          , Ds          , Ds          , Ds          , Ds          , Dd^Vdt      , Ds          , Ds          , Ds          , Ss          , Ss          , Ds          , Ds          , Ds          , Ds          , Gs^Ft       , Gs^Ft       , Wwt         , Gs^Ft       , Gs^Ft       , Ds          , Ds          , Ds          , Rd          , Ds          , Rd          , Rd          , Rd          , Ds          , Ds          , Ds          , Ds          , Dd^Vdt      , Ds          , Ds          , Gs^Ft       , Gs^Ft       , Wwt         , Wwt         , Wwt         , Wwt         , Wwt         
Gs^Ft       , Gs^Ft       , Gll^Fp      , Ds          , Gll^Fp      , Ds          , Gll^Fp      , Ss          , Ss          , Ss          , Ss          , Ds          , Ds          , Ds          , Ds          , Gs^Ft       , Gs^Ft       , Wwt         , Wwt         , Gs^Ft       , Gs^Ft       , Ds          , Gs^Ft       , Ds          , Gs^Ft       , Ds          , Ds          , Rd          , Rd          , Rd          , Rd          , Ds          , Ds          , Ds          , Ds          , Gs^Ft       , Ds          , Ds          , Ds          , Ds          , Ds          , Wwt         
Gd^Fmw      , Gs^Ft       , Gd^Fmw      , Gd^Fmw      , Gd^Fmw      , Gd^Fmw      , Gd^Fmw      , Gll^Fp      , Gll^Fp      , Gll^Fp      , Gll^Fp      , Ss          , Ds          , Dd^Vdt      , Ds          , Ds          , Ds          , Gs^Ft       , Wwt         , Wwt         , Gs^Ft       , Gs^Ft       , Gs^Ft       , Gs^Ft       , Gs^Ft       , Ds          , Ds          , Ds          , Ds          , Ds          , Ds          , Rd          , Rd          , Rd          , Rd          , Ds          , Ds          , Dd^Vdt      , Ds          , Ds          , Ds          , Gs^Ft       
Gd^Fmw      , Gd^Fmw      , Gd^Fmw      , Gd^Fmw      , Hhd^Fmf     , Hhd^Fmf     , Hhd^Fmf     , Gd^Fmw      , Hhd^Fmf     , Gd^Fmw      , Hhd^Fmf     , Gd^Fmw      , Gd^Fmw      , Ds          , Ds          , Ds^Dr       , Ds          , Gs^Ft       , Gs^Ft       , Wwt         , Gs^Ft       , Gs^Ft       , Ds          , Ds          , Ds          , Ds          , Ds^Dr       , Ds          , Ds          , Gs^Ft       , Gs^Ft       , Ds          , Ds          , Ds          , Ds          , Rd          , Rd          , Ds          , Rd          , Ds          , Ds          , Ds          
Hhd^Fmw     , Hhd^Fmw     , Hhd^Fmf     , Hhd^Fmf     , Hhd^Fmf     , Hhd^Fmf     , Mm          , Hhd^Fmf     , Hhd^Fmf     , Hhd^Fmf     , Hhd^Fmf     , Hhd^Fdf     , Hhd^Fdf     , Gd^Fmw      , Gd^Fmw      , Ds          , Ss          , Gs^Ft       , Wwt         , Wwt         , Ss          , Gs^Ft       , Ds          , Ds          , Ce          , Ds          , Ds          , Ds          , Dd^Vdt      , Ds          , Ds          , Gs^Ft       , Gs^Ft       , Ds          , Ds          , Ds          , Ds          , Rd          , Ds          , Rd          , Rd          , Ds          
Hhd^Fmf     , Hhd^Fmw     , Hhd^Fmf     , Hhd^Fmf     , Gd^Fmw      , Hhd^Fmf     , Mm          , Mm          , Hhd^Fmf     , Mm          , Mm          , Mm          , Mm          , Hhd^Fmf     , Hhd^Fdf     , Ds          , Ss          , Wwt         , Ss          , Ss          , Ss          , Gs^Ft       , Ds          , Ce          , 4 Ke        , Ce          , Ds          , Ds          , Ds          , Ds          , Ds          , Gs^Ft       , Gs^Ft       , Ds          , Gs^Ft       , Ds          , Ds          , Ds          , Ds          , Ds          , Ds          , Rd          
Hhd^Fmf     , Hhd^Fmf     , Hhd^Fmf     , Hhd^Fmf     , Mm          , Mm          , Mm          , Mm          , Mm          , Mm          , Mm          , Mm          , Mm          , Mm          , Gd^Fmw      , Ss          , Wwt         , Wwt         , Hhd^Fmf     , Gll^Fmf     , Gll^Fmf     , Ss          , Ss          , Ce          , Ce          , Ce          , Hhd^Fmf     , Ds          , Ss          , Ss          , Ss          , Ss          , Ss          , Gs^Ft       , Gll^Fmf     , Gs^Ft       , Gs^Ft       , Gs^Ft       , Gs^Ft       , Ds          , Dd^Vdt      , Ds          
Hhd^Fmf     , Hhd^Fmf     , Hhd^Fmf     , Hhd^Vhhr    , Mm          , Mm          , Mm          , Mm          , Mm          , Mm          , Hhd^Fmw     , Mm          , Hhd^Fmw     , Hhd^Fmw     , Hhd^Fmf     , Hhd^Fmf     , Ww          , Hhd^Fmf     , Mm          , Hhd^Fmf     , Hhd^Fmf     , Gll^Fmf     , Gll^Fmf     , Gll^Fmf     , Gll^Fmf     , Hhd^Fmf     , Mm          , Gll^Fmf     , Gll^Fmf     , Ss          , Ss          , Ss          , Ss          , Ss          , Gll^Fmf     , Hhd^Fmf     , Hhd^Fmf     , Gll^Fmf     , Gll^Fmf     , Gs^Ft       , Ds          , Ds          
Hhd^Fmf     , Hhd^Fmf     , Hhd^Fmf     , Mm          , Mm          , Mm          , Mm          , Mm          , Mm          , Mm          , Mm          , Hhd^Fmf     , Hhd^Fmf     , Hhd^Fdf     , Ww          , Ww          , Hhd^Vhhr    , Mm          , Mm          , Hhd^Fmf     , Mm          , Hhd^Fmf     , Hhd^Fmf     , Gll^Fmf     , Mm          , Mm          , Mm          , Hhd^Fmf     , Hhd^Fmf     , Gll^Fmf     , Gll^Fmf     , Gll^Fmf     , Gll^Fmf     , Gll^Fmf     , Hhd^Fmf     , Hhd^Fmf     , Mm          , Hhd^Fmf     , Hhd^Fmf     , Hhd^Fmf     , Hhd^Fmf     , Hd          
Mm          , Mm          , Mm          , Hhd^Fmf     , Mm          , Hhd^Fmf     , Hhd^Fmf     , Mm          , Hhd^Fmf     , Mm          , Hhd^Fmf     , Mm          , Hhd^Fmf     , Hhd^Fmf     , Ww          , Hhd^Fmf     , Hhd^Fmf     , Hhd^Fmf     , Hhd^Fmf     , Mm          , Hhd^Fdf     , Hhd^Fmf     , Hhd^Fmf     , Hhd^Fmf     , Hhd^Fmf     , Mm          , Mm          , Hhd^Fmf     , Mm          , Gll^Fmf     , Hhd^Fmf     , Gll^Fmf     , Hhd^Vhhr    , Hhd^Fmf     , Mm          , Hhd^Fmf     , Mm          , Mm          , Mm          , Hhd^Fmf     , Hhd^Fmf     , Hhd^Fmf     
Mm          , Mm          , Mm          , Mm          , Mm          , Mm          , Mm          , Mm          , Mm          , Hhd^Fmf     , Mm          , Mm          , Mm          , Ww          , Mm          , Hhd^Fmf     , Mm          , Hhd^Fmf     , Hhd^Fmf     , Hhd^Fmf     , Mm          , Hhd^Fmf     , Hhd^Fmw     , Hhd^Fmf     , Mm          , Mm          , Mm          , Mm          , Mm          , Mm          , Hhd^Fmf     , Hhd^Fmf     , Hhd^Fmw     , Mm          , Hhd^Fmw     , Mm          , Hhd^Fmf     , Mm          , Hhd^Fmf     , Mm          , Mm          , Hhd^Fmf     
