border_size=1
usage=map

Gs^Fp       , Gs^Fp       , Gs^Fp       , Gs^Fp       , Gs^Fp       , Gs^Fp       , Gs^Fp       , Gg          , Ww          , Ww          , Gg          , Gs^Fp       , Gs^Fp       , Gs^Fp       , Gg          , Gg          , Gg          , Gg          , Gg          , Gg          , Gg          , Gg          , Ss          , Gs^Ft       , Gs^Ft       , Ww          , Ww          , Ww          , Gs          , Gs          , Ss          , Ww          , Ss          , Ww          , Ss          , Ss          , Ss          , Ss          , Ss          , Ss          
Gg          , Gg          , Gg          , Gg          , Gg^Ve       , Gs^Fp       , Gg          , Gg          , Ww          , Gg          , Gg          , Gg          , Gg          , Gg          , Gs^Ft       , Gg          , Gs^Ft       , Gs^Ft       , Gs          , Gs          , Gs          , Ss          , Ss^Vm       , Ww          , Ww          , Ww          , Ss          , Gs^Ft       , Gs          , Gs          , Ss          , Ss          , Ss          , Ss          , Ss          , Ss          , Ss          , Ss          , Ss^Vhs      , Ss          
Gg          , Gg          , Gg^Wm       , Gg          , Gg          , Gg          , Gs^Ft       , Ss          , Ww          , Gs^Ft       , Ds          , Gg          , Gs^Ft       , Gs^Ft       , Gg          , Gg          , Gs          , Gs          , Ss          , Gs          , Ss          , Ss          , Ss          , Ss          , Ss          , Ss          , Gs^Ft       , Gs^Ft       , Gs          , Gs          , Gs          , Gs^Ft       , Gs          , Gs^Ft       , Gs          , Ss          , Ss          , Ss          , Ss          , Ss          
Gg          , Gg          , Gg          , Gg          , Gg          , Gs^Ft       , Gs^Ft       , Ww          , Gs^Ft       , Gs^Ft       , Gs^Ft       , Ds          , Gg          , Gg          , Gs^Ft       , Gs^Ft       , Gs          , Ss          , Ss          , Ss          , Ss          , Ss          , Ss          , Ss          , Gs^Ft       , Gs^Ft       , Gs          , Gs          , Gs^Ft       , Gs          , Gs          , Gs          , Gs          , Gs          , Gs          , Gs^Ft       , Gs^Ft       , Gs^Ft       , Gs^Ft       , Ss          
Gg          , Gg          , Re^Gvs      , Gg          , Gg          , Gs^Ft       , Ww          , Ww          , Gs^Ft       , Gs^Ft       , Ds          , Ds          , Gs          , Gs^Vht      , Gs^Ft       , Gs          , Ss          , Ss          , Gs          , Gs^Ft       , Gs^Ft       , Gs^Ft       , Gs^Ft       , Ss          , Ss          , Ss          , Ss          , Gs^Ft       , Ss          , Gs^Ft       , Gs^Ft       , Gs          , Ss          , Gs          , Ss          , Gs          , Gs          , Gs          , Gs          , Gs          
Gg          , Gg          , Re^Gvs      , Re^Gvs      , Gg          , Ww          , Gs^Ft       , Gs^Ft       , Gs^Ft       , Ds          , Ds          , Ds          , Gs          , Gs^Ft       , Ss          , Gs^Ft       , Ss          , Ss          , Gs          , Gs          , Gs          , Gs          , Gs          , Gs          , Gs          , Gs^Ft       , Ss          , Ss          , Ss^Vhs      , Gs^Ft       , Ss          , Gs^Ft       , Ss          , Ss          , 3 Ss        , Ss          , Gs          , Gs          , Gs          , Gs          
Gg          , Re^Gvs      , Re^Gvs      , Gg          , Gg          , Ww          , Ww          , Gs^Ft       , Gs^Ft       , Ds          , Ds          , Gs          , Gs^Ft       , Gs^Ft       , Ss          , Ss          , Ss          , Gs^Ft       , Gs^Ft       , Ss          , Ss          , Gs          , Gs^Ft       , Gs^Ft       , Gs^Ft       , Gs          , Gs^Ft       , Ss          , Ss          , Ss          , Gs^Ft       , Ss          , Gs          , Gs          , Gs          , Gs          , Gs          , Gs          , Gs^Ft       , Ss          
Gg          , Gg          , Gg          , Gg          , Gs^Ft       , Gs^Ft       , Ww          , Gs^Ft       , Ds          , Ds          , Ds          , Ds          , Ds          , Gs^Ft       , Gs^Ft       , Ss          , Ww          , Ss          , Ss          , Ss          , Gs          , Gs          , Gs^Ft       , Ss          , Gs^Ft       , Gs^Ft       , Gs^Ft       , Ss          , Gs^Ft       , Ss          , Gs          , Gs          , Gs^Ft       , Ss          , Gs^Ft       , Ss          , Ss          , Gs^Ft       , Ss          , Ss          
Gg          , Gg          , Gg          , Gg          , Gs^Ft       , Ww          , Gs^Ft       , Gs^Ft       , Gs^Ft       , Ds          , Ds          , Ds          , Gs^Ft       , Gs^Ft       , Ss          , Ss          , Ww          , Ww          , Ss          , Gs^Ft       , Gs          , Gs^Ft       , Ss          , Ss          , Ss          , Gs^Ft       , Gs          , Gs^Ft       , Gs^Ft       , Gs^Ft       , Ss          , Ss          , Ss          , Ss          , Ss          , Ss          , Ss          , Ss          , Ss          , Ss          
Gg          , Gg^Vc       , Gg          , Gs^Ft       , Gs^Ft       , Ww          , Ww          , Gs^Ft       , Gs^Ft       , Ds          , Gs^Ft       , Ds          , Gs^Ft       , Ss          , Ss          , Ss          , Ss          , Ss          , Gs          , Gs          , Gs^Ft       , Gs^Ft       , Ss          , Ss          , Ss          , Ss          , Gs          , Ss          , Gs^Ft       , Gs^Ft       , Ss          , Gs^Ft       , Gs^Ft       , Ss          , Gs^Ft       , Ss          , Ss          , Gs          , Gs^Ft       , Ss          
Gs^Ft       , Gg          , Gg          , Gg          , Gs^Ft       , Gs^Ft       , Ww          , Gs^Ft       , Gs^Ft       , Gs^Ft       , Ww          , Gs^Ft       , Ww          , Ww          , Ss          , Ss          , Ss          , Gs          , Gs          , Gs          , Gs^Ft       , Ss          , Ss          , Ss          , Ss          , Gs^Ft       , Gs          , Ss          , Gs          , Ss          , Gs^Ft       , Gs          , Gs          , Gs^Ft       , Ss          , Ss          , Gs          , Gs          , Gs          , Ss          
Gs^Ft       , Gs^Ft       , Gs^Ft       , Gg          , Gs^Ft       , Gs^Ft       , Gs^Ft       , Ww          , Ww          , Ww          , Chw         , Ww          , Ss          , Ss          , Gs^Ft       , Gs^Ft       , Gs^Ft       , Ss          , Gs^Ft       , Ss          , Gs^Ft       , Gs^Ft       , Ss          , Ss^Vhs      , Ss          , Ss          , Ss          , Gs^Ft       , Gs          , Gs^Ft       , Gs          , Gs          , Gs          , Gs          , Gs^Ft       , Ss          , Ss          , Gs^Vht      , Gs          , Gs          
Ds          , Gs^Ft       , Gs^Ft       , Gg          , Gg          , Gs^Ft       , Ww          , Ww          , Chw         , Gg^Fet      , Gg^Fet      , Ss          , Chw         , Gs^Ft       , Gs          , Gs^Ft       , Gs^Ft       , Ss          , Ss          , Ss          , Ss          , Ss          , Gs          , Gs          , Gs          , Gs^Ft       , Ss          , Ss          , Gs          , Gs          , Gs^Ft       , Ss          , Gs^Ft       , Gs          , Gs^Ft       , Ss          , Ss          , Gs          , Gs          , Gs          
Ds          , Ds          , Gs^Ft       , Gs^Ft       , Gg          , Gs^Ft       , Ss          , Gg^Fet      , Gg^Fet      , Gg^Fet      , 1 Khw       , Ww          , Ww          , Gg^Fet      , Gs^Ft       , Gs          , Gs^Ft       , Ss          , Ss          , Ss          , Gs^Ft       , Ss          , Gs          , Gs          , Gs          , Ss          , Gs^Ft       , Ss          , Ss          , Gs          , Gs          , Ss          , Ss          , Gs^Ft       , Gs^Ft       , Gs^Ft       , Ss          , Ss          , Gs^Ft       , Gs          
Ds          , Ds          , Gs^Ft       , Gg          , Gg^Vc       , Gg          , Gg^Fet      , Ss          , Ss          , Gg^Fet      , Chs         , Chw         , Ww          , Gg^Fet      , Gs^Ft       , Gs^Ft       , Ss          , Ss          , Gs^Ft       , Gs^Ft       , Gs          , Gs^Ft       , Gs^Ft       , Gs^Ft       , Gs          , Gs          , Gs^Ft       , Gs^Ft       , Ss          , Ss          , Gs^Ft       , Gs^Ft       , Ss          , Ss          , Gs          , Gs          , Ss          , Gs^Ft       , Gs          , Gs          
Ds          , Ds          , Gs^Ft       , Gg          , Gg          , Gg          , Gg^Fet      , Ww          , Ss          , Chs         , Ss          , Chs         , Chs         , Ss          , Ss          , Ss          , Ss^Vm       , Ss          , Gs^Ft       , Gs          , Gs^Ft       , Gs          , Gs^Ft       , Gs          , Gs^Ft       , Gs^Ft       , Gs^Ft       , Gs^Ft       , Gs^Ft       , Ss          , Ss          , Ss          , Ss          , Gs^Ft       , Gs^Ft       , Gs^Ft       , Gs^Ft       , Ss          , Gs          , Gs          
Ds          , Ds          , Ds          , Gs^Ft       , Gs^Ft       , Gg^Fet      , Ww          , Ww          , Chs         , Ss          , Gs^Ft       , Ss          , Ss          , Ss          , Ss          , Ss          , Ss          , Ss          , Ss          , Gs^Ft       , Ss          , Gs^Ft       , Ss          , Gs^Ft       , Ss          , Gs^Ft       , Ss          , Gs^Ft       , Gs^Ft       , Gs^Ft       , Ss          , Gs^Ft       , Ss          , Gs^Ft       , Ss          , Gs^Ft       , Ss          , Ss          , 2 Gs        , Ss          
Ww          , Ds          , Ds          , Ds          , Ds          , Ds          , Ww          , Ss          , Gg^Fet      , Gs^Ft       , Gg^Fet      , Chs         , Gg^Fet      , Gs^Ft       , Gs^Ft       , Gs^Ft       , Gs^Ft       , Ss          , Ss          , Ss          , Ss          , Ss          , Ss          , Ss          , Ss^Vm       , Ss          , Ss          , Gs^Ft       , Gs^Ft       , Gs^Ft       , Ss          , Gs^Ft       , Gs^Ft       , Ss          , Ss          , Ss^Vhs      , Ss          , Ss          , Ss          , Gs          
Wwr         , Ww          , Ww          , Ds          , Ds          , Wwt         , Ds          , Ds          , Ds          , Gg^Fet      , Ds          , Gg^Fet      , Ds          , Gs^Ft       , Gs^Ft       , Gs^Ft       , Gs^Ft       , Gs^Ft       , Gs^Ft       , Gs^Ft       , Gs^Ft       , Ss          , Ss          , Ss          , Ss          , Ss          , Ss          , Ss          , Ss          , Ss          , Ss          , Gs^Ft       , Gs^Ft       , Gs^Ft       , Gs^Ft       , Ss          , Gs^Ft       , Ss          , Gs          , Gs          
Ww          , Wwr         , Ww          , Wwt         , Wwt         , Wwt         , Ds          , Ds          , Ds          , Ds          , Ds          , Ds          , Dd^Vdt      , Ds          , Ds          , Ds          , Ds          , Gs^Ft       , Gs^Ft       , Gs^Ft       , Gs^Ft       , Gs^Ft       , Gs^Ft       , Gs^Ft       , Gs^Ft       , Gs^Ft       , Gs^Ft       , Ss          , Ss          , Ss          , Gs^Ft       , Gs^Ft       , Gs^Ft       , Gs^Ft       , Gs^Ft       , Gs^Ft       , Gs^Ft       , Gs          , Gs          , Gs          
Wwt         , Ww          , Wwt         , Wwt         , Wwt         , Wwt         , Wwt         , Ds          , Wwt         , Ds          , Wwt         , Ds          , Ds          , Ds          , Ds          , Ds          , Ds          , Ds          , Ds          , Ds          , Ds          , Gs^Ft       , Ds          , Gs^Ft       , Gs^Ft       , Gs^Ft       , Gs^Ft       , Gs^Ft       , Gs^Ft       , Gs^Ft       , Ds          , Gs^Ft       , Ds          , Ds          , Ds          , Gs^Ft       , Gs^Ft       , Gg          , Gg          , Gg          
Ww          , Wwt         , Wwt         , Wwt         , Wwt         , Wwt         , Wwt         , Wwt         , Wwt         , Wwt         , Wwt         , Wwt         , Wwt         , Wwt         , Wwt         , Ds          , Ds          , Ds          , Ds          , Ds          , Ds          , Ds          , Ds          , Ds          , Ds          , Ds          , Ds          , Ds          , Ds          , Ds          , Ds          , Ds          , Ds          , Ds          , Ds          , Gs^Ft       , Gs^Ft       , Gs^Ft       , Gs^Ft       , Gg          
