border_size=1
usage=map

Ds          , Ss          , Ss          , Ds          , Ds          , Ds          , Ds          , Ds          , Ss          , Ds          , Ss          , Ss          , Ss          , Ds          , Ss          , Ds          , Ds          , Ds          , Ds          , Ds          , Ds          , Gs^Ft       , Gs^Ft       , Gs^Ft       , Gs^Ft       , Gs^Ft       , Gs^Ft       , Gs^Ft       , Gs^Ft       , Gs^Ft       , Gs^Ft       , Gs^Ft       , Gs^Ft       , Gs^Ft       , Ds          , Ds          , Ds          , Ds          
Ds          , Ds          , Ss          , Ss          , Ss          , Ds          , Ds          , Ss          , Ds          , Ss          , Gs^Ft       , Ss          , Ss          , Ss          , Ss          , Dd^Vdt      , Ds          , Ds          , Gs^Ft       , Ds          , Ds          , Ds          , Gs^Ft       , Gs^Ft       , Ds          , Ds          , Gs^Ft       , Gs^Ft       , Gs^Ft       , Ds          , Ds          , Ds          , Gs^Ft       , Ds          , Gs^Ft       , Gs^Ft       , Gs^Ft       , Ds          
Gs^Ft       , Gs^Ft       , Ce          , Ce          , Ce          , Ds          , Rd          , Ds          , Rd          , Ds          , Ds          , Gs^Ft       , Ss          , Gs^Ft       , Gs^Ft       , Ss          , Ss          , Gs^Ft       , Gs^Ft       , Ds          , Ds          , Gs^Ft       , Gs^Ft       , Gs^Ft       , Ds          , Ds          , Gs^Ft       , Gs^Ft       , Gs^Ft       , Ds          , Ds          , Ds          , Ds          , Ds          , Gs^Ft       , Gg^Ve       , Gs^Ft       , Gs^Ft       
Ss          , Gs^Ft       , Ce          , 1 Ke        , Ce          , Ds          , Ds          , Rd          , Ds          , Rd          , Rd          , Ds          , Ss          , Ds          , Ds          , Ss          , Ss          , Gs^Ft       , Ds          , Ds          , Ds          , Gs^Ft       , Ds          , Ds          , Gs^Ft       , Gg^Ve       , Gs^Ft       , Ds          , Ds          , Ds          , Gs^Ft       , Gs^Ft       , Ds          , Ds          , Ds          , Gs^Ft       , Gs^Ft       , Gs^Ft       
Ss          , Ss          , Ss          , Ce          , Gs^Ft       , Gs^Ft       , Ds          , Ds          , Gs^Ft       , Ds          , Ss          , Ss^Bw\      , Rd          , Ds          , Ds          , Ss          , Ds          , Gs^Ft       , Ds          , Ds^Dr       , Ds          , Ds          , Ds          , Ds          , Ds          , Gs^Ft       , Ds          , Ds          , Gs^Ft       , Ds          , Ds          , Gs^Ft       , Ds          , Ds^Edp      , Ds          , Ds          , Gs^Ft       , Gs^Ft       
Ww          , Ss          , Ss          , Ss          , Ss          , Gs^Ft       , Gs^Ft       , Gs^Ft       , Ss          , Ss          , Gs^Ft       , Ss          , Gs^Ft       , Rd          , Rd          , Ds          , Rd          , Ds          , Ds          , Ds          , Rd          , Rd          , Rd          , Ds          , Rd          , Ds          , Ss          , Ds          , Ds          , Ds          , Ds          , Ds          , Ds          , Ds          , Ds          , Gs^Ft       , Gs^Ft       , Ds          
Ww          , Ww          , Ss          , Ss^Vhs      , Ss          , Ss          , Ss          , Gs^Ft       , Ss          , Ss          , Gs^Ft       , Gs^Ft       , Gs^Ft       , Ds          , Ds          , Rd          , Ds          , Rd          , Ce          , Ce          , Ce          , Ds          , Ds          , Rd          , Ds          , Rd          , Ss^Bw\      , Ds          , Rd          , Ds          , Rd          , Ds          , Ds          , Ds          , Ds          , Ds          , Ds          , Ds          
Wo          , Ww          , Ww          , Ss          , Ss          , Ss          , Ss          , Ss          , Ss          , Ss          , Ss          , Ss          , Ss          , Gs^Ft       , Gs^Ft       , Ds          , Gs^Ft       , Ds          , Ce          , 4 Ke        , Ce          , Gs^Ft       , Gs^Ft       , Ds          , Ds          , Ss          , Ss          , Rd          , Ds          , Rd          , Ds          , Rd          , Ds          , Ds          , Ds          , Ds          , Ds          , Ds          
Wo          , Wo          , Wo          , Ww          , Ww          , Ww          , Ww          , Ss          , Ww          , Ss          , Ss          , Ss^Vm       , Ss          , Gs^Ft       , Ss          , Gs^Ft       , Ss          , Gs^Ft       , Ss          , Ce          , Ss          , Ss          , Gs^Ft       , Gs^Ft       , Ss          , Ss          , Gs^Ft       , Ds          , Gs^Ft       , Ds          , Ds          , Ds          , Ds          , 2 Ds        , Ds          , Ds          , Ds          , Ds          
Ww          , Wo          , Wo          , Wo          , Wo          , Ww          , Ww          , Ww          , Ww          , Ww          , Ww          , Ss          , Ww          , Ss          , Ww          , Ss          , Ww          , Ss          , Ww          , Ss          , Ss          , Ss          , Ss          , Ss          , Ss^Vm       , Ss          , Gs^Ft       , Gs^Ft       , Gs^Ft       , Ds          , Gs^Ft       , Ds          , Ds          , Ds          , Ds          , Ds          , Gs^Ft       , Ds          
Ww          , Ww          , Ww          , Wo          , Wo          , Wo          , Wo          , Wo          , Wo          , Ww          , Wo          , Ww          , Ww          , Ww          , Ww          , Ww          , Ww          , Ww          , Ww          , Ww          , Ww          , Ww          , Ww          , Ss          , Ss          , Ss          , Ss          , Ss          , Ss          , Gs^Ft       , Gs^Ft       , Ss          , Ss          , Ss          , Gs^Ft       , Gs^Ft       , Ss          , Ds          
Ss          , Ww          , Ww          , Ww          , Ww          , Ww          , Ww          , Wo          , Wo          , Wo          , Wo          , Wo          , Wo          , Wo          , Wo          , Wo          , Wo          , Wo          , Wo          , Wo          , Wo          , Ww          , Ww          , Ww          , Ww          , Ww          , Ww          , Ss          , Ss          , Ss          , Ss          , Ss          , Ss^Vm       , Ss          , Ss          , Gs^Ft       , Ss          , Ss          
Gs          , Ss          , Gs          , Ww          , Ss          , Ww          , Ww          , Ww          , Ww          , Ww          , Ww          , Wo          , Wo          , Wo          , Wo          , Wo          , Ww          , Wo          , Ww          , Wo          , Wo          , Wo          , Wo          , Wo          , Wo          , Ww          , Ww          , Ww          , Ww          , Ww          , Ww          , Ss          , Ss          , Ss          , Ss          , Ss          , Ss          , Ss          
Hh^Fmw      , Gs          , Hh^Fmw      , Gs          , Gs          , Gs          , Gs          , Ss          , Gs          , Ww          , Ss          , Ww          , Ww          , Ww          , Ww          , Ww          , Ww          , Ww          , Ww          , Ww          , Ww          , Wo          , Wo          , Wo          , Wo          , Wo          , Wo          , Wo          , Wo          , Ww          , Wo          , Ww          , Ww          , Ww          , Ww          , Ww          , Ww          , Ww          
Mm          , Hh^Fmw      , Hh^Vhh      , Hh^Fmw      , Hh^Fmw      , Hh^Fmw      , Hh^Fmw      , Gs          , Gs^Fmw      , Gs          , Gs          , Ss          , Ww          , Ww          , Hh^Fds      , Ww          , Gs          , Gs          , Ww          , Ww          , Ww          , Ww          , Ww          , Ww          , Ww          , Wo          , Ww          , Wo          , Wo          , Wo          , Wo          , Wo          , Wo          , Wo          , Wo          , Wo          , Wo          , Ww          
Mm          , Mm          , Mm          , Mm          , Mm          , Hh^Fmw      , Mm          , Hh^Fmw      , Hh^Fmw      , Hh^Fms      , Ww          , Ww          , Ss          , Hh^Fds      , 3 Ke        , Hh^Fds      , Hh^Fds      , Ss          , Hh^Fmw      , Hh^Fds      , Hh^Fds      , Ss          , Wwg         , Ww          , Ww          , Ww          , Ww          , Ww          , Ww          , Ww          , Ww          , Wo          , Ww          , Wo          , Wo          , Wo          , Wo          , Wo          
Mm          , Mm          , Ss          , Mm          , Mm          , Mm          , Mm          , Mm          , Mm          , Hh^Fmw      , Ww          , Hh^Fmw      , Ss          , Mm          , Ce          , Ce          , Mm          , Ss          , Mm          , Mm          , Mm          , Hh^Fds      , Ww          , Ss          , Gs          , Ss          , Gs          , Ss          , Gs          , Ww          , Ss          , Ww          , Ww          , Ww          , Ww          , Ww          , Ww          , Wo          
Mm          , Ss          , Ss          , Ss          , Ss          , Ss          , Ss          , Mm          , Ss          , Ww          , Ss          , Mm          , Ss          , Hh^Fmw      , Mm          , Mm          , Mm          , Ss          , Hh^Fmw      , Hh^Fdw      , Mm          , Mm          , Ww          , Gs          , Gs          , Gs          , Hh^Fds      , Gs          , Hh^Fds      , Gs          , Gs          , Ss          , Gs          , Ww          , Ss          , Ww          , Ww          , Ww          
Mm          , Mm          , Ss          , Ss          , Hh^Fp       , Hh^Fp       , Hh^Fp       , Ss          , Hh^Fp       , Ww          , Ss          , Mm          , Ss          , Mm          , Mm          , Mm          , Mm          , Ss          , Mm          , Mm          , Mm          , Ss          , Mm          , Ww          , Ww          , Hh^Fds      , Hh^Vhh      , Hh^Fds      , Hh^Fds      , Hh^Fds      , Hh^Fds      , Gs          , Hh^Fds      , Gs          , Gs          , Ss          , Gs          , Ss          
Mm          , Mm          , Mm          , Ss          , Ss          , Hh^Fp       , Ss          , Ss          , Ww          , Ww          , Hh^Fms      , Ss          , Mm          , Hh^Fp       , Hh^Vhh      , Hh^Fp       , Hh^Fms      , Ss          , Ss          , Ss          , Ss          , Ss          , Mm          , Mm          , Ww          , Mm          , Mm          , Mm          , Mm          , Mm          , Mm          , Hh^Fds      , Mm          , Hh^Fds      , Hh^Fds      , Gs          , Gs          , Ss          
Mm          , Mm          , Mm          , Ss          , Ss          , Ss          , Ss^Vm       , Ss          , Ww          , Mm          , Mm          , Ss          , Hh^Fms      , Mm          , Mm          , Hh^Fp       , Mm          , Mm          , Hh^Fmw      , Mm          , Mm          , Mm          , Mm          , Ww          , Ss          , Ww          , Ww          , Hh^Fds      , Hh^Fds      , Hh^Fds      , Mm          , Mm          , Mm          , Mm          , Hh^Fds      , Hh^Vhh      , Hh^Fds      , Gs          
Mm          , Mm          , Mm          , Mm          , Mm          , Ss          , Ss          , Ss          , Ww          , Mm          , Hh^Fmw      , Mm          , Hh^Fmw      , Mm          , Mm          , Mm          , Mm          , Mm          , Hh^Fmw      , Mm          , Mm          , Mm          , Ww          , Ww          , Ss          , Ss          , Ww          , Mm          , Mm          , Hh^Fds      , Mm          , Mm          , Mm          , Mm          , Mm          , Hh^Fds      , Hh^Fds      , Hh^Fds      
