border_size=1
usage=map

Ha          , Aa          , Aa          , Ds          , Ds          , Ds          , Ds          , Ds          , Ds          , Ds          , Ds          , Ds          , Ds          , Ds          , Ha          , Ha          , Ds          , Ds          , Hd          , Hd          , Hd          , Hd          , Ds          , Ha          , Ha          , Ms          , Ha          , Ha          , Ha          , Ha          , Ha          , Ds          , Ds          , Hd          , Hd          , Ds          
Ha          , Ha          , Aa          , Aa          , Ds          , Ds          , Ds          , Ds          , Ds          , Aa          , Aa          , Aa          , Aa          , Ds          , Ds          , Ha          , Ds          , Ds          , Ds          , Ds          , Ds          , Ds          , Ds          , Ds          , Ds          , Ha          , Ds          , Ds          , Ds          , Ds          , Ds          , Ds          , Ds          , Ds          , Ds          , Ds          
Ha          , Ha          , Ha          , Aa          , Ds          , Ds          , Ds          , Aa          , Aa          , Aa          , Ha          , Ha          , Ha          , Aa          , Aa          , Ds          , Ds          , Dd^Vdt      , Ds          , Aa          , Aa          , Aa          , Aa          , Ds          , Aa          , Ds          , Aa          , Ds          , Aa          , Ds          , Ha          , Ha          , Ds          , Aa          , Aa          , Aa          
Md          , Ms          , Ha          , Aa          , Ds          , Ds          , Aa          , Aa          , Ha          , Ha          , Aa          , Aa          , Aa          , Aa          , Aa          , Aa          , Ds          , Ds          , Aa          , Aa          , Ds          , Aa          , Ds          , Aa          , Ds          , Aa          , Aa          , Aa          , Aa          , Ds          , Ds          , Ds          , Ds          , Aa          , Aa          , Aa          
Md          , Ha          , Ha^Fpa      , Aa          , Aa          , Ds          , Aa          , Aa          , Aa          , Ha          , Aa          , Ds          , Ds          , Ds          , Ds          , Ds          , Ds          , Ds          , Ds          , Aa          , Ds          , Ds          , Ha          , Ds          , Aa          , Aa^Voa      , Aa          , Aa          , Ds          , Ds          , Ce          , Ce          , Cea         , Aa          , Aa          , Aa          
Ha          , Ha          , Aa          , Aa          , Ms          , Aa          , Aa          , Ds          , Ds          , Aa          , Ds          , Ds          , Aa          , Aa          , Aa          , Aa          , Aa          , Ds          , Ds          , Ds          , Ds          , Ds          , Ds          , Ha          , Ds          , Aa          , Ds          , Ds          , Ds          , Ds          , Cea         , 3 Kea       , Ce          , Ds          , Ds          , Ds          
Aa          , Aa          , Aa          , Ha          , Ms          , Ha^Fpa      , Aa          , Dd^Vdt      , Ds          , Ds          , Aa          , Aa          , Ha          , Ha          , Ha          , Aa          , Aa          , Ds          , Ds          , Ds          , Aa          , Aa          , Aa          , Ds          , Aa          , Ds          , Ds          , Ds          , Aa          , Ds          , Aa          , Cea         , Ds          , Ds          , Ds          , Ds          
Aa          , Aa          , Ha^Fpa      , Ha^Fpa      , Ms^Xm       , Ha^Fpa      , Aa          , Ds          , Aa          , Ds          , Aa          , Ha          , Ha          , Ms          , Ms          , Ha          , Hh^Fp       , Aa          , Ds          , Ds          , Aa          , Ha          , Ha          , Aa          , Aa          , Ds          , Ds          , Ds          , Ds          , Aa          , Aa          , Aa          , Aa          , Aa          , Aa          , Ds          
Aa          , Aa          , Ha^Fpa      , Ms          , Ms^Xm       , Ha^Fpa      , Ha^Fpa      , Aa          , Ha^Fpa      , Aa          , Ha^Fpa      , Ha          , Ha          , Ms          , Ms          , Ms          , Hh^Fp       , Aa          , Aa          , Ds          , Aa          , Aa          , Ha          , Ha          , Aa          , Aa          , Ds          , Ds          , Aa          , Aa          , Aa          , Aa          , Hd          , Ha          , Ds          , Ds          
Ha          , Ha          , Ha^Fpa      , Ms          , Ms^Xm       , Ms          , Ha^Fpa      , Ha^Fpa      , Ms          , Ha^Fpa      , Ms          , Ms          , Ms          , Ha          , Ms          , Ms          , Hh^Fp       , Ss          , Ds          , Ds          , Ds          , Aa          , Aa          , Ha          , Aa          , Ds          , Ds          , Ds          , Aa          , Hd          , Mm          , Mm          , Ds          , Ds          , Dd^Vdt      , Ds          
Ms          , Ms          , Ms          , Ms          , Ms^Xm       , Ms          , Ms          , Ms          , Ha^Fpa      , Ms          , Ms          , Ms          , Ms          , Ms          , Ha          , Hh^Fp       , Ss          , Ss          , Ds          , Dd^Vdt      , Ds          , Aa          , Ds          , Aa          , Aa          , Aa          , Ds          , Ds          , Aa          , Hd          , Mm          , Mm          , Mm          , Ds          , Ds          , Ds          
Ms          , Ms          , Ms          , Ms          , Ms^Xm       , Ms          , Ha^Fpa      , Ha^Fpa      , Aa          , Ha^Fpa      , Ha^Fpa      , Ha^Fpa      , Ha^Fpa      , Ha^Fpa      , Aa          , Aa          , Ds          , Ss          , Ss          , Ds          , Ss          , Ds          , Ds          , Ds          , Ds          , Ds          , Ds          , Ds          , Aa          , Hh^Fp       , Hh^Fp       , Mm          , Mm          , Hd          , Aa          , Ds          
Ms          , Ms          , Ms          , Ms          , Ms          , Ha^Fpa      , Aa          , Aa          , Aa^Vha      , Aa          , Aa          , Aa          , Aa          , Aa          , Aa          , Aa          , Ds          , Ss          , Hh^Fp       , Hh^Fp       , Hh^Fp       , Ss          , Ss          , Ss          , Ss          , Ss          , Hh^Fp       , Ds          , Ds          , Hh^Fp       , Aa          , Mm          , Aa          , Aa          , Aa          , Ds          
Ms          , Ms          , Ms          , Mm          , Mm          , Ha^Fpa      , Aa          , Aa          , Aa          , Aa          , Aa          , Aa          , Ha          , Aa          , Ds          , Ds          , Aa          , Wwf         , Ww          , Mm          , Mm          , Hh^Fp       , Hh^Fp       , Hh^Fp       , Hh^Fp       , Hh^Fp       , Hh^Fp       , Ss          , Ss          , Ds          , Ds          , Aa          , Aa          , Aa          , Aa          , Aa          
Ms          , Ms          , Ms          , Mm          , Mm          , Ha^Fpa      , Aa          , Aa          , Ds          , Ds          , Aa          , Ha          , Aa          , Aa          , Ds          , Ds          , Wwf         , Wwf         , Ww          , Ww          , Ww          , Mm          , Hh^Fp       , Hh^Fp       , Hh^Fp       , Md          , Hh^Fp       , Hh^Fp       , Ss          , Ds          , Ds          , Aa          , Aa          , Aa          , Ds          , Ds          
Mm          , Ms          , Mm          , Mm          , Mm          , Ha^Fpa      , Ha^Fpa      , Aa          , Aa          , Ds          , Ds          , Aa          , Ds          , Ds          , Ds          , Ds          , Wwf         , Ww          , Ww          , Ww          , Mm          , Mm          , Hh^Fp       , Gll^Fp      , Gll^Fp      , Hh^Fp       , Hh^Fp       , Ss          , Ds          , Ds          , Aa          , Aa          , Ha          , Aa          , Aa          , Ds          
Mm          , Mm          , Mm          , Mm          , Mm          , Mm          , Ha^Fpa      , Aa          , Aa          , Aa          , Ds          , Ds          , Aa          , Ds          , Ds          , Ss          , Ss          , Wwf         , Wwf         , Ww          , Mm          , Mm          , Hh^Fp       , Gll^Fp      , Gll^Fp      , Hh^Fp       , Ss          , Ss          , Ds          , Aa          , Aa          , Ha          , Ms          , Ha          , Ha          , Aa          
Mm          , Mm          , Mm          , Mm          , Mm          , Mm          , Ha^Fpa      , Ha^Fpa      , Aa          , Ds          , Ds          , Aa          , Aa          , Aa          , Ds          , Ss          , Ss          , Ss          , Aa          , Mm          , Hh^Fp       , Hh^Fp       , Hh^Fp       , Gg^Ve       , Gll^Fp      , Hh^Fp       , Ss          , Ds          , Ds          , Ds          , Ha          , Ha          , Md          , Ms          , Ms          , Ms          
Mm          , Mm          , Ms          , Ms          , Ms          , Mm          , Mm          , Ha^Fpa      , Ha^Fpa      , Aa          , Aa          , Aa          , Aa          , Ds          , Ds          , Ss          , Ss          , Hh^Fp       , Hh^Fp       , Aa          , Hh^Fp       , Hh^Fp       , Hh^Fp       , Hh^Fp       , Hh^Fp       , Hh^Fp       , Ss          , Ss          , Ds          , Ds          , Ha          , Ms          , Ha^Vhha     , Md          , Md          , Ms          
Mm          , Mm          , Ms          , Ms          , Ms          , Mm          , Mm          , Mm          , Ha^Fpa      , Aa          , Aa          , Aa          , Aa          , Aa^Voa      , Ds          , Ss          , Ss          , Ss          , Ss          , Hh^Fp       , Ss          , Hh^Fp       , Ss          , Aa          , Aa          , Aa          , Ss          , Hh^Fp       , Hh^Fp       , Hh^Fp       , Hh^Fp       , Ha          , Ha          , Md          , Md          , Md          
Mm          , Mm          , Ms          , Ms          , Ms          , Mm          , Mm          , Mm          , Ms          , Ha^Fpa      , Ha^Fpa      , Aa          , Aa          , Ds          , Aa          , Ai          , Ai          , Ai          , Ai          , Ss          , Ds          , Ss          , Ss          , Ss          , Ss          , Ss          , Ai          , Ss          , Ds          , Ss          , Ss          , Aa          , Aa          , Hh^Fp       , Hh^Fp       , Hh^Fp       
Mm          , Mm          , Ms          , Ha^Vhha     , Ms          , Mm          , Mm          , Mm          , Ms          , Ms          , Ha          , Ha^Fpa      , Aa          , Aa          , Aa          , Aa          , Aa          , Aa          , Aa          , Ai          , Aa          , Ds          , Ds          , Ai          , Ai          , Ss          , Ai          , Ds          , Ai          , Ai          , Ss          , Ss          , Ai          , Aa          , Ss          , Ai          
Mm          , Mm          , Ms          , Ha          , Ms          , Mm          , Mm          , Mm          , Ms          , Ms          , Ha^Fpa      , Ha^Fpa      , Ha^Fpa      , Aa          , Ha^Fpa      , Ha^Fpa      , Ha^Fpa      , Ha^Fpa      , Aa          , Aa          , Aa          , Ds          , Aa          , Aa          , Aa          , Ss          , Ai          , Ai          , Ss          , Ss          , Ai          , Ss          , Ss          , Ss          , Aa          , Ss          
Mm          , Mm          , Mm          , Ms          , Mm          , Mm          , Mm          , Ms          , Ha^Fpa      , Ha^Fpa      , Ms          , Ms          , Ms          , Ha^Fpa      , Ms          , Ms          , Ms          , Ha          , Ha          , Aa          , Aa          , Aa          , Aa          , Aa          , Hh^Fp       , Hh^Fp       , Hh^Fp       , Ai          , Aa          , Aa          , Aa          , Aa          , Ss          , Aa          , Aa          , Aa          
Mm          , Mm          , Mm          , Mm          , Mm          , Mm          , Ms          , Ms          , Ms          , Ha^Fpa      , Ms          , Ms          , Ms          , Ha^Fpa      , Ms          , Ms          , Ms          , Ha          , Ha          , Ha          , Ha          , Hh^Fp       , Hh^Fp       , Hh^Fp       , Hh^Fp       , Hh^Fp       , Cea         , Cea         , Cea         , Aa          , Aa          , Aa          , Aa          , Ss          , Aa          , Aa          
Mm          , Mm          , Mm          , Mm          , Mm          , Ms          , Ms          , Ms          , Ha^Fpa      , Aa          , Ha          , Ms          , Ha^Fpa      , Ha^Fpa      , Ms          , Ms          , Ms          , Ha^Vhha     , Ms          , Ha          , Ms          , Hh^Fp       , Ms          , Hh^Fp       , Ha          , Ha          , Cea         , 1 Kea       , Cea         , Ha          , Ha          , Ha          , Hh^Fp       , Ss          , Ss          , Ai          
Mm          , Mm          , Mm          , Mm          , Ms          , Ms          , Ha^Fpa      , Ha^Fpa      , Aa          , Aa          , Ha          , Ha          , Ha^Fpa      , Ms          , Ms          , Ms          , Ms          , Ms          , Ms          , Ms          , Ms          , Ms          , Ms          , Ms          , Ha          , Aa          , Aa          , Cea         , Ha          , Ha          , Ms          , Ms          , Hh^Fp       , Ss          , Ai          , Ai          
Mm          , Mm          , Mm          , Mm          , Ms          , Ms          , Ha^Fpa      , Aa          , Ha          , Ha          , Ha          , Aa          , Ha^Fpa      , Ms          , Ms          , Ms          , Ms          , Ms          , Ms          , Ms          , Ms          , Ms          , Ms          , Ha          , 2 Ha        , Aa          , Aa          , Ha          , Ms          , Ms          , Ms          , Ha          , Ha          , Ai          , Ha          , Aa          
Mm          , Mm          , Mm          , Mm          , Ms          , Ha          , Aa^Vla      , Aa          , Ms          , Ha          , Aa          , Ha^Fpa      , Ms          , Ms          , Ms          , Ms          , Mm          , Ha          , Ha          , Ha          , Ms          , Ms          , Ms          , Ha          , Aa          , Aa          , Aa          , Ha          , Ms          , Ms          , Ms          , Ms          , Ha          , Ha          , Ha          , Ha          
Mm          , Mm          , Mm          , Ms          , Ha^Fpa      , Ha          , Aa          , Ha          , Ms          , Ms          , Ha^Fpa      , Ha^Fpa      , Ms          , Ms          , Ms          , Ms          , Mm          , Md          , Md          , Md          , Mm          , Ms          , Ha          , Ha          , Aa          , Dd          , Dd          , Aa          , Ha          , Ha          , Ha          , Ha^Vhha     , Ha          , Ms          , Ms          , Ms          
Mm          , Mm          , Ms          , Ha^Fpa      , Ha^Fpa      , Ha^Fpa      , Ha          , Ha          , Ha          , Ha^Fpa      , Ha^Fpa      , Ms          , Ms          , Ms          , Ms          , Ms          , Ms          , Mm          , Ms          , Mm          , Ha          , Ha          , Aa          , Aa          , Dd          , Dd          , Aa          , Aa          , Ha          , Ms          , Ms          , Ha          , Ms          , Ms          , Ms          , Ms          
Ms          , Ms          , Ha^Fpa      , Ha^Fpa      , Aa          , Aa          , Ha          , Ha          , Ha          , Aa          , Ha^Fpa      , Ms          , Ms          , Ms          , Ms          , Ms          , Ms          , Ms          , Ms          , Ha          , Aa          , Aa          , Dd          , Dd          , Aa          , Aa          , Ha          , Ha          , Ms          , Ms          , Ms          , Ms          , Ha          , Ha          , Ms          , Ms          
