border_size=1
usage=map

Ww          , Gs^Ft       , Ds          , Rd          , Gg          , Ss          , Ss          , Wog         , Gs^Ft       , Gs^Ft       , Gs^Ft       , Ch          , Rr          , Rr          , Rr          , Rr          , Rr          , Rp          , Rr          , Rr          , Rr          , Rr          , Rr          , Ch          , Gs^Ft       , Gs^Ft       , Wog         , Gs^Ft       , Ww          , Gs^Ft       , Gs^Ft       , Gs^Ft       , Gs^Ft       , Gs^Ft       , Gs^Ft       , Gs^Ft       , Rd          , Gs          , Gs          , Gs          , Gg          , Gs          , Rd          , Ds          , Ww          , Ww          
Ww          , Gs^Ft       , Ds          , Rd          , Gg          , Ss          , Ss          , Wog         , Gs^Ft       , Gs^Ft       , Gs^Ft       , Ss          , Rr          , Rr          , Rr          , Rr          , Rr          , Rr          , Rr          , Rr          , Rr          , Rr          , Rr          , Ss          , Gs^Ft       , Gs^Ft       , Wog         , Ww          , Ss          , Ww          , Ww          , Ww          , Ww          , Ww          , Ww          , Gs^Ft       , Rd          , Gs          , Gs          , Gd^Vo       , Gs          , Gs          , Rd          , Ds          , Ww          , Ww          
Ww          , Gs^Ft       , Ds          , Rd          , Rd          , Gg          , Ss          , Wog         , Gs^Ft       , Gs^Ft       , Gs^Ft       , Ss          , Rr          , Rr          , Rr          , Rr          , Ch          , Ch          , Ch          , Rr          , Rr          , Rr          , Rr          , Ss          , Gs^Ft       , Gs^Ft       , Wog         , Ss          , Gg          , Ss          , Gg          , Gg          , Gg          , Gg          , Rd          , Wo^Bsb/     , Gs          , Gs          , Hh          , Gs          , Gs          , Gs          , Rd          , Ds          , Gs^Ft       , Ww          
Ww          , Gs^Ft       , Gs^Ft       , Ds          , Rd          , Gg          , Gg          , Wog         , Wog         , Gs^Ft       , Gs^Ft       , Ss          , Rr          , Rr          , Rr          , Rr          , Ch          , 2 Kh        , Ch          , Rr          , Rr          , Rr          , Rr          , Ss          , Gs^Ft       , Gs^Ft       , Wog         , Gg          , Hh          , Gg          , Gs^Ft       , Gs^Ft       , Gg          , Cd          , 3 Kd        , Ww          , Gs          , Hh          , Gs          , Hh          , Gs          , Rd          , Ds          , Ds          , Gs^Ft       , Ww          
Ww          , Gs^Ft       , Gs^Ft       , Ds          , Rd          , Gg          , Gg          , Wog         , Ss          , Gs^Ft       , Gs^Ft       , Ss          , Rr          , Rr          , Rr          , Rr          , Rr          , Ch          , Rr          , Rr          , Rr          , Rr          , Rr          , Ss          , Gs^Ft       , Gs^Ft       , Wog         , Gg          , Hh          , Gg          , Gs^Ft       , Gs^Ft       , Gg          , Cd          , Chw         , Chw         , Ww          , Gs          , Gd^Vo       , Gs          , Rd          , Rd          , Ds          , Gs^Ft       , Ww          , Ww          
Ww          , Ww          , Gs^Ft       , Ds          , Ds          , Rd          , Gg          , Wog         , Ss          , Gs^Ft       , Gs^Ft       , Ss          , Rr          , Rr          , Rr          , Rr          , Rr          , Rr          , Rr          , Rr          , Rr          , Rr          , Rr          , Ss          , Gs^Ft       , Gs^Ft       , Wog         , Gs          , Gg          , Gg          , Gs^Ft       , Gs^Ft       , Gg          , Rd          , Gs^Ft       , Gs^Ft       , Ww          , Gs          , Gs          , Gs          , Rd          , Ds          , Gs^Ft       , Gs^Ft       , Ww          , Ww          
Ww          , Ww          , Gs^Ft       , Gs^Ft       , Ds          , Rd          , Gg          , Wog         , Ss          , Gs^Ft       , Re          , Ch          , Ss          , Rr          , Rr          , Rr          , Rr          , Rr          , Rr          , Rr          , Rr          , Rr          , Ss          , Ch          , Re          , Gs^Ft       , Wog         , Gs          , Gd^Vo       , Gg          , Gg          , Gg          , Gg          , Rd          , Rd          , Gs^Ft       , Gs^Ft       , Ww          , Ww          , Gs          , Rd          , Ds          , Gs^Ft       , Ww          , Ww          , Ww          
Ww          , Ww          , Gs^Ft       , Gs^Ft       , Ds          , Rd          , Gg          , Wog         , Ch          , Re          , Gs^Ft       , Gs^Ft       , Gs^Ft       , Ss          , Ss          , Rr          , Rr          , Rr          , Rr          , Rr          , Ss          , Ss          , Gs^Ft       , Gs^Ft       , Gs^Ft       , Re          , Ch          , Gs          , Gs          , Gs          , Rd          , Rd          , Rd          , Rd          , Gs          , Rd          , Rd          , Gs^Ft       , Ww          , Gs          , Rd          , Ds          , Gs^Ft       , Ww          , Ww          , Ww          
Ww          , Ww          , Gs^Ft       , Ds          , Ds          , Rd          , Rd          , Gg          , Gg          , Wog         , Wog         , Gs^Ft       , Gs^Ft       , Ss          , Wog         , Ss          , Ss          , Rr          , Ss          , Ss          , Gs^Ft       , Gs^Ft       , Gs^Ft       , Gs^Ft       , Wog         , Wog         , Gs^Ft       , Rd          , Rd          , Rd          , Gs          , Gs          , Rd          , Hh          , Hh          , Gs          , Rd          , Gs^Ft       , Wo^Bsb/     , Wo^Bsb/     , Ds          , Ds          , Gs^Ft       , Ww          , Ww          , Ww          
Ww          , Ww          , Gs^Ft       , Ds          , Dd^Vdt      , Ds          , Rd          , Gg          , Gg          , Ss          , Ss          , Wog         , Wog         , Wog         , Gs^Ft       , Gs^Ft       , Gs^Ft       , Ch          , Gs^Ft       , Gs^Ft       , Gs^Ft       , Gs^Ft       , Wog         , Wog         , Gs^Ft       , Gs^Ft       , Hh          , Gs^Ft       , Rd          , Gs          , Gs          , Hh          , Ds          , Ds          , Ds          , Hh          , Rd          , Rd          , Ss          , Ww          , Ww          , Gs^Ft       , Ww          , Ww          , Ww          , Ww          
Ww          , Ww          , Gs^Ft       , Ds          , Ds          , Ds          , Rd          , Gg          , Gs^Ft       , Gg          , Gg          , Wog         , Wog         , Ss          , Wog         , Gs^Ft       , Gs^Ft       , Re          , Gs^Ft       , Gs^Ft       , Wog         , Wog         , Gs^Ft       , Wog         , Gs          , Hh          , Gs          , Gs^Ft       , Rd          , Gs          , Gs^Ft       , Hh          , Ds          , Ds          , Ds          , Rd          , Gs^Ft       , Ss          , Ss          , Ss          , Ww          , Ww          , Ww          , Ww          , Ww          , Ww          
Ww          , Ww          , Gs^Ft       , Gs^Ft       , Ds          , Ds          , Rd          , Gg          , Gs^Ft       , Gg          , Gg          , Ss          , Ww          , Wog         , Ss          , Wog         , Wog         , Re          , Wog         , Wog         , Gs^Ft       , Gs^Ft       , Gs          , Gs          , Gs          , Gg          , Gs          , Rd          , Gs          , Gs          , Gd^Vo       , Hh          , Hh          , Ds          , Hh          , Rd          , Ss          , Ss          , Ss          , Ss          , Ss          , Ww          , Wo          , Wo          , Ww          , Ww          
Ww          , Ww          , Ww          , Gs^Ft       , Gs^Ft       , Ds          , Rd          , Gs          , Gs          , Gs^Ft       , Gs^Ft       , Gg          , Ww          , Ww          , Ww          , Gg          , Gg          , Ch          , Rd          , Gs^Ft       , Gs          , Gg          , Gd^Vo       , Gs          , Gs          , Hh          , Gs          , Rd          , Rd          , Gs          , Gs          , Gs^Ft       , Ss          , Ss          , Ss          , Ss^Bsb|     , Ss          , Ss          , Ss          , Ss^Vm       , Ww          , Ww          , Wo          , Ww          , Ww          , Ww          
Ww          , Ww          , Ww          , Gs^Ft       , Ds          , Ds          , Rd          , Gs          , Gd^Vo       , Gs          , Gs^Ft       , Gg          , Gg          , Ww          , Ww          , Ss          , Ss          , Gg          , Gg          , Rd          , Rd          , Gs          , Gs          , Gg          , Hh          , Hh          , Gs          , Gs          , Rd          , Gs          , Gs          , Gs          , Gg          , Ss          , Ss          , Ss^Bsb|     , Ss          , Ss          , Ww          , Ss          , Ww          , Ww          , Wo          , Wo          , Ww          , Ww          
Ww          , Ww          , Ww          , Gs^Ft       , Ds          , Ds          , Rd          , Gs          , Gs          , Gs          , Gs^Ft       , Gg          , Gg          , Gg          , Ss          , Ww          , Ww          , Ss          , Ss          , Gg          , Gg          , Rd          , Rd          , Gs          , Gs          , Hh          , Gs          , Gs          , Gs          , Rd          , Gs          , Gs^Ft       , Gs^Ft       , Gg          , Gg          , Rd          , Ss          , Ss          , Ww          , Ww          , Ww          , Ww          , Wo          , Wo          , Ww          , Ww          
Ww          , Ww          , Ww          , Gs^Ft       , Gs^Ft       , Ds          , Ds          , Rd          , Rd          , Gs          , Gg          , Gs^Ft       , Gs^Ft       , Gg          , Gg          , Ss          , Ss          , Ww          , Ss          , Gs^Ft       , Gs^Ft       , Gg          , Gg          , Rd          , Rd          , Gs          , Gs          , Gg          , Gs          , Rd          , Rd          , Gs          , Gg          , Gg          , Rd          , Rd          , Ss          , Ww          , Ww          , Ww          , Ww          , Ww          , Ww          , Ww          , Ww          , Ww          
Wo          , Ww          , Ww          , Ww          , Gs^Ft       , Ds          , Ds          , Ds          , Ds          , Rd          , Gg          , Gs^Ft       , Gs^Ft       , Gg          , Gs          , Gs^Ft       , Ss          , Ww          , Ww          , Ss          , Gs^Ft       , Gs^Ft       , Gs^Ft       , Gg          , Gg          , Rd          , Gs          , Gd^Vo       , Gg          , Gs          , Rd          , Gg          , Gd^Vo       , Gg          , Rd          , Ds          , Gs^Ft       , Ww          , Ww          , Ww          , Ww          , Wo          , Ww          , Ww          , Ss          , Ss          
Wo          , Ww          , Ww          , Ww          , Ww          , Gs^Ft       , Gs^Ft       , Ds          , Ds          , Rd          , Rd          , Gg          , Gg          , Gs          , Gd^Vo       , Gs          , Gs^Ft       , Ss          , Ww          , Ss          , Ss          , Gs^Ft       , Gs^Ft       , Gs^Ft       , Gg          , Rd          , Rd          , Gg          , Gg          , Rd          , Gs          , Gg          , Gg          , Gg          , Rd          , Ds          , Gs^Ft       , Ww          , Ww          , Ww          , Wo          , Wo          , Ww          , Ww          , Ss          , Ss          
Ww          , Wo          , Wo          , Ww          , Ww          , Gs^Ft       , Ww          , Gs^Ft       , Ds          , Ds          , Ds          , Rd          , Gg          , Gs          , Gg          , Gs          , Gg          , Ss          , Ww          , Ss          , Ss          , Ss          , Gs^Ft       , Gs^Ft       , Gs^Ft       , Gg          , Rd          , Gg          , Gg          , Rd          , Rd          , Gg          , Rd          , Rd          , Ds          , Ds          , Ww          , Ww          , Ww          , Ww          , Wo          , Wo          , Ww          , Ww          , Ss          , Ss          
Ww          , Wo          , Wo          , Ww          , Ww          , Ww          , Ww          , Gs^Ft       , Chw         , Ce          , Ds          , Rd          , Rd          , Gg          , Gg          , Gs^Ft       , Gs          , Ss          , Ss          , Ww          , Ww          , Gs^Ft       , Gs          , Gg          , Gg          , Gg          , Rd          , Gg          , Rd          , Rd          , Ds          , Rd          , Ds          , Ds          , Gs^Ft       , Ww          , Ww          , Ww          , Wo          , Wo          , Wo          , Wo          , Ww          , Ss          , Ss^Vhs      , Ss          
Ww          , Ww          , Wo          , Wo          , Wo          , Ww          , Ww          , Ww          , Ww          , Chw         , Ds          , Ds          , Ds          , Rd          , Gg          , Gs^Ft       , Gs          , Gs          , Gs          , Ss          , Ww          , Gs^Ft       , Gs          , Gd^Vo       , Gs          , Gs          , Rd          , Rd          , Ds          , Ds          , Ds          , Ds          , Gs^Ft       , Gs^Ft       , Ww          , Ww          , Ww          , Ww          , Wo          , Wo          , Wo          , Ww          , Ww          , Ss          , Ss          , Gs          
Ww          , Ww          , Ww          , Wo          , Wo          , Wo          , Wo          , Ww          , Ww          , Chw         , Ds          , Ds          , Ds          , Rd          , Rd          , Gg          , Gs          , Gd^Vo       , Gs          , Gs^Ft       , Ww          , Gs^Ft       , Gs^Ft       , Gs          , Rd          , Rd          , 4 Ke        , Cd          , Ds          , Ds          , Ww          , Ww          , Ww          , Ww          , Ww          , Ww          , Wo          , Ww          , Ww          , Wo          , Ww          , Ww          , Ss          , Ss          , Ss          , Gs          
Gs^Ft       , Ww          , Ww          , Ww          , Ww          , Wo          , Wo          , Wo          , Ww          , Ww          , Ww          , Ds          , Ds          , Ds          , Ds          , Rd          , Rd          , Gs          , Gs^Ft       , Gs^Ft       , Ww^Bw/      , Rd          , Re          , Re          , Ds          , Cd          , Chw         , Chw         , Wwf         , Wwf         , Ww          , Ww          , Ww          , Ww          , Ww          , Wo          , Wo          , Ww          , Ww          , Ww          , Ww          , Ww          , Ss          , Ss          , Gs          , Gs          
Gs^Ft       , Gs^Ft       , Ww          , Ww          , Wo          , Wo          , Wo          , Wo          , Wo          , Ww          , Ww          , Ww          , Ww          , Ds          , Ww          , Ds          , Ds          , Rd          , Rd          , Rd          , Ww          , Gs^Ft       , Gs^Ft       , Gs^Ft       , Ss          , Wwf         , Wwf         , Wwf         , Ww          , Ww          , Ww          , Ww          , Wo          , Wo          , Wo          , Wo          , Ww          , Ww          , Ss          , Ss          , Ss          , Ss          , Gg          , Ss          , Gs          , Gs          
Gs^Ft       , Gs^Ft       , Gs^Ft       , Ww          , Ww          , Ww          , Wo          , Wo          , Wo          , Wo          , Wo          , Ww          , Ww          , Ww          , Ww          , Ds          , Gs^Ft       , Ds          , Gs^Ft       , Gs^Ft       , Ww          , Ss          , Ss          , Ss          , Ww          , Wwf         , Ww          , Ww          , Ww          , Ww          , Ww          , Wo          , Ww          , Ww          , Ww          , Ww          , Ww          , Ww          , Ss          , Gg          , Gg          , Gg          , Gs^Ft       , Gg          , Gs          , Gg          
Gs^Ft       , Gs^Ft       , Gs^Ft       , Ww          , Ww          , Ww          , Ww          , Wo          , Wo          , Wo          , Wo          , Wo          , Wo          , Ww          , Ww          , Ww          , Ss          , Gs^Ft       , Ss          , Ss          , Ww          , Ww          , Ww          , Ww          , Ww          , Ww          , Ww          , Ww          , Wo          , Wo          , Wo          , Wo          , Ww          , Ww          , Ss          , Ww          , Ss          , Ss          , Gg          , Gg          , Gs^Ft       , Gs^Ft       , Gg          , Gs          , Gs          , Gs          
Gs^Ft       , Gs^Ft       , Gs^Ft       , Gs^Ft       , Gs^Ft       , Ww          , Ww          , Ww          , Ww          , Wo          , Wo          , Wo          , Wo          , Wo          , Ww          , Ww          , Ww          , Ss          , Ww          , Ww          , Ww          , Ww          , Ww          , Ww          , Wo          , Wo          , Wo          , Wo          , Wo          , Wo          , Ww          , Ww          , Ww          , Ww          , Ss          , Ss          , Gg          , Gg          , Gs^Ft       , Gg          , Gg          , Gg          , Gs          , Gs^Vh       , Gg          , Gg          
Gg          , Gs^Ft       , Gs^Ft       , Gs^Ft       , Gs^Ft       , Ww          , Ww          , Ww          , Ww          , Wo          , Wo          , Wo          , Wo          , Wo          , Wo          , Ww          , Ww          , Ww          , Ww          , Ww          , Wo          , Wo          , Wo          , Wo          , Wo          , Wo          , Wo          , Wo          , Ww          , Ww          , Ww          , Ww          , Ss          , Ss          , Gg          , Gg          , Gs^Ft       , Gs^Ft       , Gg          , Gg          , Gg          , Gg          , Gg          , Gg          , Hh^Fp       , Hh^Fp       
Gs          , Gs          , Gs          , Gs^Ft       , Gs^Ft       , Gs^Ft       , Ww          , Ww          , Ww          , Ww          , Wo          , Wo          , Wo          , Wo          , Wo          , Wo          , Wo          , Wo          , Wo          , Wo          , Wo          , Wo          , Wo          , Wo          , Ww          , Ww          , Ww          , Ww          , Ww          , Ww          , Gs^Ft       , Gs^Ft       , Gg          , Gg          , Gs^Ft       , Gg          , Gg          , Gg          , Gg          , Gg          , Gs^Ft       , Gs^Ft       , Gg          , Gg          , Hh^Fp       , Hh^Fp       
Gg          , Gs          , Gg          , Gs^Ft       , Gs^Ft       , Gs^Ft       , 1 Ww        , Ww          , Ww          , Ww          , Wo          , Wo          , Wo          , Wo          , Wo          , Wo          , Wo          , Wo          , Wo          , Wo          , Ww          , Wo          , Ww          , Ww          , Ww          , Ww          , Ww          , Ww          , Gs^Ft       , Gs^Ft       , Gg          , Gg          , Gs^Ft       , Gs^Ft       , Gg          , Gg          , Gg          , Gs^Ft       , Gs^Ft       , Gg          , Gg          , Gg          , Hh^Fp       , Hh^Fp       , Hh^Fp       , Mm          
Gg          , Gg          , Gs^Vc       , Gg          , Gs^Ft       , Ww          , Ww          , Ww          , Ww          , Ww          , Ww          , Wo          , Wo          , Wo          , Wo          , Wo          , Wo          , Wo          , Ww          , Wo          , Ww          , Ww          , Ww          , Ww          , Ss          , Ss          , Ss          , Ss          , Ss          , Gg          , Gs^Vh       , Gg          , Gg          , Gg          , Gg          , Gg          , Gs^Ft       , Gs^Vht      , Gg          , Gg          , Hh^Fp       , Gg          , Hh^Fp       , Hh^Fp       , Mm          , Mm          
Gg          , Gg          , Gg          , Gg          , Gs^Ft       , Ww          , Ww          , Ww          , Ww          , Ww          , Wo          , Wo          , Wo          , Wo          , Wo          , Wo          , Ww          , Ww          , Ww          , Ww          , Ww          , Ww          , Ww          , Ww          , Gg          , Ss          , Ss          , Ss          , Ss          , Gg          , Gg          , Gg          , Gg          , Hh^Fp       , Hh^Fp       , Gg          , Gg          , Gg          , Gg          , Hh^Fp       , Mm          , Hh^Fp       , Mm          , Mm          , Mm          , Mm          
Gg          , Gg          , Gs          , Gs^Ft       , Ww          , Ww          , Ww          , Ww          , Ww          , Ww          , Ww          , Wo          , Wo          , Wo          , Wo          , Ww          , Ww          , Ww          , Ww          , Ww          , Ss          , Ss          , Gg          , Ww          , Gs^Ft       , Gg          , Gs^Ft       , Gs^Ft       , Gg          , Gg          , Hh^Fp       , Hh^Fp       , Hh^Fp       , Hh^Fp       , Gg          , Gg          , Hh^Fp       , Hh^Fp       , Hh^Fp       , Hh^Fp       , Mm          , Mm          , Mm          , Mm          , Ms          , Ms          
Gg          , Gs          , Ss          , Gs^Ft       , Ss          , Ww          , Ww          , Ww          , Wo          , Wo          , Wo          , Wo          , Wo          , Wo          , Ww          , Ww          , Ww          , Ss          , Ss          , Ss          , Gg          , Ss          , Gg          , Gs^Ft       , Gs^Ft       , Gs^Ft       , Gg          , Gg          , Gg          , Hh^Fp       , Hh^Fp       , Hh^Fp       , Hh^Fp       , Hh^Fp       , Hh^Fp       , Hh^Fp       , Mm          , Mm          , Mm          , Mm          , Mm          , Mm          , Ms          , Ms          , Ms          , Ms          
