border_size=1
usage=map

Xuc         , Xuc         , Ss          , Ss          , Ww          , Ww          , Ww          , Ww          , Ww          , Ww          , Ww          , Ww          , Ww          , Ds          , Ds          , Ds          , Gg          , Gg          , Gg          , Gs^Ft       , Gs^Ft       , Gs^Ft       , Gs^Ft       , Gs^Ft       , Gs^Ft       , Gs^Ft       , Gg          , Gg          , Gg          , Gg          , Xuc         , Xuc         , Xuc         , Xuc         , Xuc         , Xuc         , Xuc         , Xuc         
Wwg         , Xuc         , Xuc         , Ss          , Ss          , Ss          , Ss          , Ww          , Ss          , Ss          , Ss          , Ww          , Ww          , Ds          , Ds          , Ds          , Gg          , Gg          , Gs          , Gg          , Gg^Fet      , Gs^Ft       , Gs          , Gg^Fet      , Gg          , Gg          , Gg          , Gg          , Xuc         , Xuc         , Uu          , Uu          , Uu          , Uu          , Uu          , Uu          , Uu          , Uu          
Ww          , Ww          , Xuc         , Ss          , Xuc         , Xuc         , Xuc         , Ss          , Xuc         , Xuc         , Xuc         , Ss          , Gs^Ft       , Ds          , Ds          , Gs^Ft       , Gg^Fet      , Gg          , Gs^Ft       , Gs          , Gs          , Gs          , Gs          , Gg          , Gg          , Gg          , Xuc         , Xuc         , Uu          , Uu          , Uu          , Uu^Vu       , Uu          , Uu          , Uu^Br/      , Uu^Br\      , Uu^Br/      , Uu^Br/      
Ww          , Wwg         , Xuc         , Xuc         , Urb         , Ss          , Ss          , Xuc         , Ww          , Ww          , Ww          , Xuc         , Xuc         , Gs^Ft       , Gs^Ft       , Gs^Ft       , Gs^Ft       , Gs^Ft       , Gs          , Gs          , Gs          , Gs^Vl       , Gs          , Gg          , Gg          , Xuc         , Uu^Uf       , Uu          , Uu          , Uu          , Uu          , Uu^Br/      , Uu^Br\      , Uu^Br/      , Uu          , Uu          , Uu          , Uu          
Ww          , Wwg         , Wwg         , Xuc         , Urb         , Urb         , Wwf         , Xuc         , Ww          , Ww^Vm       , Ww          , Ss          , Ss          , Xuc         , Xuc         , Gs^Ft       , Gs^Ft       , Gs^Ft       , Gg^Fet      , Gg          , Rr^Vhc      , Gs^Ft       , Gg          , Gg          , Gg          , Xuc         , Uu          , Uu          , Uu          , Uu          , Cud         , Uu          , Urb         , Uu          , Urb         , Uu^Vu       , Urb         , Urb         
Wwg         , Wwg         , Wwg         , Xuc         , Xuc         , Urb         , Wwf         , Xuc         , Xuc         , Ww          , Ss          , Ss          , Urb         , Ss          , Ss          , Xuc         , Xuc         , Gs^Ft       , Gs^Ft       , Gs^Ft       , Gs^Ft       , Gs^Ft       , Gg          , Gg          , Xuc         , Xuc         , Gs^Ft       , Uu          , Urb         , Cud         , 2 Kud       , Cud         , Ss          , Urb         , Ss          , Urb         , Ss          , Ss          
Ww          , Wwg         , Ss^Vm       , Ss          , Ss          , Ss          , Wwf         , Ss          , Ss          , Xuc         , Ss          , Urb         , Uu          , Urb         , Urb         , Ss          , Ss          , Xuc         , Xuc         , Gs^Ft       , Gs^Ft       , Gs^Ft       , Gs^Ft       , Gs^Ft       , Xuc         , Gs^Ft       , Gs^Ft       , Uu          , Urb         , Cud         , Cud         , Cud         , Ss          , Ss          , Ss          , Urb         , Ss          , Xuc         
Ww          , Ww          , Ww          , Ss          , Wwg         , Ss          , Ss          , Wwf         , Ss          , Xuc         , Ss          , Urb         , Uu          , Uu          , Uu          , Urb         , Urb         , Ss          , Ss          , Xuc         , Xuc         , Gs^Ft       , Xuc         , Gs^Ft       , Xuc         , Gs^Ft       , Ss          , Ss          , Ss          , Urb         , Ss          , Ss          , Ss          , Ss          , Ss          , Urb         , Ss          , Xuc         
Wwg         , Wwg         , Wwg         , Ww          , Ww          , Wwg         , Wwf         , Ss^Vhs      , Ss          , Xuc         , Ss          , Urb         , Uu          , Xuc         , Cud         , Uu          , Uu          , Urb         , Urb         , Ss          , Ss          , Xuc         , Ss          , Xuc         , Gs^Ft       , Gs^Ft       , Ss          , Ss          , Ss^Vm       , Ss          , Ss          , Urb         , Ss          , Ss          , Urb         , Urb         , Ss          , Xuc         
Xuc         , Xuc         , Wwg         , Ww          , Wwg         , Wwg         , Ss          , Ss          , Uu          , Xuc         , Xuc         , Urb         , Xuc         , Xuc         , Xuc         , Xuc         , Xuc         , Uu          , Uu          , Urb         , Urb         , Ss          , Urb         , Ss          , Ss          , Ss          , Ss^Bw/      , Ss          , Ss          , Ss          , Xuc         , Ss          , Xu          , Urb         , Xu          , Xu          , Xuc         , Xuc         
Xuc         , Wwg         , Wwg         , Wwg         , Wwg         , Ss          , Ss          , Uu^Emf      , Xuc         , Xuc         , Ss          , Xuc         , Urb         , Uu          , Uu          , Uu          , Uu          , Xuc         , Xuc         , Uu          , Uu          , Urb         , Uu          , Urb         , Urb         , Urb         , Ss          , Ss          , Xuc         , Xuc         , Uu          , Xuc         , Ss          , Xu          , Ss          , Ss          , Xuc         , Xuc         
Xuc         , Wwg         , Wwg         , Wwg         , Chw         , Wwg         , Ss          , Ss          , Xuc         , Ss          , Ss          , Urb         , Ss          , Urb         , Urb         , Urb         , Urb         , Uu          , Uu          , Xuc         , Xuc         , Uu          , Xuc         , Uu          , Uu          , Ss          , Xuc         , Xuc         , Uu          , Uu          , Rd          , Uu          , Uu          , Ss^Bw|      , Ss          , Xuc         , Xuc         , Xuc         
Xuc         , Wwg         , Wwg         , Chw         , 4 Khw       , Chs         , Ss          , Ss          , Ss          , Xuc         , Cud         , Wwf         , Xuc         , Ss          , Ss          , Ss          , Ss          , Urb         , Uu          , Uu^Vu       , Xuc         , Cud         , Xuc         , Xuc         , Xuc         , Xuc         , Uu          , Uu          , Rd          , Rd          , Ds          , Rd          , Rd          , Rd          , Ss          , Xuc         , Xuc         , Xuc         
Ss          , Ss          , Ss          , Chs         , Chs         , Chs         , Urb         , Ss          , Ss          , Xuc         , Xuc         , Xuc         , Cud         , Xuc         , Xuc         , Xuc         , Ss          , Urb         , Uu          , Uu^Vu       , Xuc         , Xuc         , Uu          , Uu          , Uu          , Uu          , Rd          , Rd          , Ds          , Ds          , Ww          , Ds          , Ds          , Ds          , Ds          , Ss          , Ss          , Xuc         
Ss          , Ss          , Ss          , Ss          , Ss          , Urb         , Uu          , Urb         , Urb         , Ss          , Ss          , Urb         , Urb         , Xuc         , Ss          , Ss          , Urb         , Urb         , Uu          , Xuc         , Uu^Vu       , Uu          , Urb         , Urb         , Uu          , Rd          , Rd          , Dd^Vdt      , Ds          , Ww          , Ds          , Wwg         , Wwg         , Ds          , Ss          , Ss          , Ss          , Xuc         
Ss          , Ss^Vhs      , Ss          , Ss          , Uu          , Urb         , Uu          , Uu          , Uu          , Urb         , Ss          , Ss          , Ss          , Xuc         , Ss          , Urb         , Urb         , Uu          , Xuc         , Xuc         , Xuc         , Uu          , Uu          , Uu          , Xuc         , Xuc         , Xuc         , Rd          , Rd          , Ds          , Rd          , Ds          , Ds          , Ss          , Ss          , Ss^Vhs      , Ss          , Xuc         
Ss          , Ss          , Ss          , Xuc         , Uu          , Urb         , Uu          , Xuc         , Uu          , Urb         , Urb         , Urb         , Ss          , Xuc         , Ss          , Urb         , Urb         , Cud         , Xuc         , Dd^Vdt      , Ds          , Xuc         , Xuc         , Xuc         , Ds          , Ds          , Ds          , Xuc         , Xuc         , Co          , Co          , Rd          , Rd          , Ds          , Ds          , Ss          , Ss          , Xuc         
Ss          , Ss          , Ss          , Xuc         , Uu          , Urb         , Uu          , Xuc         , Uu          , Uu          , Urb         , Urb         , Urb         , Ss          , Urb         , Ss          , Urb         , Xuc         , Ss          , Ds          , Rd          , Ds          , Ds          , Ds          , Rd          , Rd          , Rd          , Ds          , Ds          , Xuc         , Cud         , Xuc         , Ds          , Rd          , Rd          , Ds          , Ss          , Xuc         
Ss          , Ss          , Ss          , Xu          , Uu          , Urb         , Uu          , Xuc         , Uu          , Uu^Vu       , Uu          , Urb         , Urb         , Urb         , Urb         , Urb         , Urb         , Xuc         , Ss          , Rd          , Ds          , Rd          , Rd          , Rd          , Ds          , Ds          , Ds          , Rd          , Ds          , Xuc         , 3 Kud       , Xuc         , Xuc         , Ds          , Rd          , Ds          , Ss          , Xuc         
Ss          , Ss          , Ss          , Xuc         , Uu          , Urb         , Uu          , Xuc         , Xuc         , Uu          , Xuc         , Uu          , Uu          , Urb         , Uu          , Uu          , Uu          , Xuc         , Xuc         , Ss          , Ss          , Ss          , Ss          , Ds          , Xuc         , Xuc         , Ds          , Rd          , Ds          , Xuc         , Xuc         , Cud         , Cud         , Ds          , Rd          , Ds          , Ss          , Xuc         
Ss          , Ss          , Ss          , Xuc         , Uu          , Urb         , Urb         , Uu          , Uu          , Xuc         , Uu          , Xuc         , Xuc         , Cud         , Xuc         , Xuc         , Xuc         , Xuc         , Uu          , Xuc         , Xuc         , Xuc         , Xuc         , Xuc         , Uu^Vu       , Xuc         , Ds          , Rd          , Ds          , Xuc         , Ds          , Cud         , Ds          , Ds          , Rd          , Ds          , Ss          , Xuc         
Ss          , Ss          , Ss          , Ss          , Ss          , Uu          , Uu          , Urb         , Urb         , Uu          , Urb         , Uu          , Uu          , Xuc         , Uu          , Uu          , Uu          , Uu          , Urb         , Uu          , Uu          , Xuc         , Uu          , Uu          , Uu          , Xuc         , Ds          , Rd          , Rd          , Ds          , Rd          , Ds          , Rd          , Rd          , Ds          , Ds          , Ss          , Xuc         
Ss          , Ss          , Ss          , Ss          , Ss^Vhs      , Ss          , Uu          , Urb         , Urb         , Urb         , Urb         , Urb         , Urb         , Uu          , Urb         , Urb         , Urb         , Urb         , 1 Urb       , Urb         , Urb         , Uu          , Urb         , Urb         , Uu          , Xuc         , Xuc         , Ds          , Ds          , Rd          , Ds          , Rd          , Ds          , Ds          , Ss          , Ss          , Ss          , Xuc         
Ss          , Ss          , Ss          , Ss          , Ss          , Ss          , Ss          , Uu          , Uu          , Uu          , Uu          , Urb         , Urb         , Urb         , Urb         , Urb         , Urb         , Urb         , Urb         , Urb         , Urb         , Urb         , Urb         , Urb         , Urb         , Uu          , Uu          , Xuc         , Ss          , Ds          , Ss          , Ds          , Ss          , Ss          , Ss          , Ss          , Xuc         , Xuc         
Wwg         , Ss          , Wwg         , Wwg         , Wog         , Ss          , Wog         , Ss          , Ss          , Ss          , Ss          , Uu          , Uu          , Urb         , Uu          , Uu          , Uu          , Uu          , Uu          , Uu          , Uu          , Urb         , Uu          , Urb         , Urb         , Urb         , Uu          , Xuc         , Xuc         , Ss          , Ss          , Ss          , Ss^Vm       , Ss          , Ss          , Ss          , Xuc         , Xuc         
Ss          , Wwg         , Ss          , Ss          , Ss          , Wog         , Ss          , Ss          , Ss          , Xuc         , Xuc         , Ss          , Xuc         , Uu          , Xuc         , Xuc         , Xuc         , Xuc         , Xuc         , Xuc         , Xuc         , Uu          , Xuc         , Uu          , Urb         , Urb         , Urb         , Uu          , Uu          , Xuc         , Xuc         , Ss          , Ss          , Ss          , Xuc         , Xuc         , Uu          , Uu          
Wwg         , Ss          , Ss          , Ss          , Ss          , Ss          , Ss          , Ss          , Gs^Ft       , Gs^Ft       , Gs^Ft       , Xuc         , Gs^Ft       , Xuc         , Gs^Ft       , Gs^Ft       , Gs^Ft       , Gs^Ft       , Gs^Ft       , Uu          , Uu          , Xuc         , Xuc         , Uu          , Uu          , Urb         , Urb         , Urb         , Urb         , Uu          , Uu          , Xuc         , Xuc         , Xuc         , Uu          , Uu          , Urb         , Urb         
Wwg         , Ss          , Wwg         , Ss          , Wwg         , Ss          , Ss          , Ss          , Ds          , Gs^Ft       , Ds          , Gs^Ft       , Gs^Ft       , Gs^Ft       , Gs^Ft       , Gs^Ft       , Ds          , Cd          , Gs^Ft       , Gs^Ft       , Urb         , Uu          , Uu          , Xuc         , Xuc         , Uu          , Uu          , Urb         , Urb         , Urb         , Urb         , Uu          , Uu          , Uu          , Urb         , Urb         , Urb         , Urb         
Wwg         , Wwg         , Wwg         , Wwg         , Ww          , Wwg         , Wwg         , Ds          , Ds          , Ds          , Ds          , Ds          , Cd          , Kd          , Ds          , Ds          , Rd          , Ds          , Gs^Ft       , Gs^Ft       , Gs^Ft       , Urb         , Urb         , Uu          , Uu          , Xuc         , Xuc         , Uu          , Uu          , Urb         , Urb         , Urb         , Urb         , Urb         , Urb         , Urb         , Uu          , Uu          
Ww          , Ww          , Ww          , Ww^Vm       , Ww          , Wwg         , Ww          , Ww          , Ww          , Ww          , Ds          , Ds          , Ds          , Rd          , Rd          , Rd          , Ds          , Rd          , Cd          , Gs^Ft       , Gs^Ft       , Gs^Ft       , Urb         , Urb         , Urb         , Uu          , Uu          , Xuc         , Uu          , Uu          , Uu^Vu       , Urb         , Urb         , Urb         , Uu          , Uu          , Xuc         , Xuc         
Wwg         , Wwg         , Wwg         , Wwg         , Wwg         , Ww          , Ww          , Ww          , Ww          , Ww          , Ww          , Ds          , Ds          , Ds          , Ds          , Ds          , Gs^Ft       , Cd          , Gs^Ft       , Gs^Ft       , Gs^Ft       , Gs^Ft       , Uu          , Urb         , Urb         , Urb         , Urb         , Uu          , Urb         , Uu          , Urb         , Urb         , Urb         , Uu          , Xuc         , Xuc         , Xuc         , Xuc         
Ss          , Wwg         , Wwg         , Wwg         , Wwg         , Wwg         , Wwg         , Wwg         , Wwg         , Ww          , Ww          , Ww          , Ww          , Ds          , Ds          , Ds          , Ds          , Gs^Ft       , Gs^Ft       , Gs^Ft       , Xuc         , Xuc         , Xuc         , Uu          , Uu^Vu       , Urb         , Urb         , Urb         , Urb         , Urb         , Urb         , Urb         , Uu          , Uu          , Xuc         , Xuc         , Xuc         , Xuc         
Ss          , Ss          , Ss          , Ss          , Ss          , Wwg         , Ss          , Wwg         , Wwg         , Wwg         , Ww          , Ww          , Ww          , Ds          , Ds          , Dd^Vdt      , Ds          , Gs^Ft       , Gs^Ft       , Gs^Ft       , Xuc         , Xuc         , Xuc         , Uu          , Uu          , Uu          , Uu          , Uu          , Uu          , Uu          , Uu          , Uu          , Xuc         , Xuc         , Xuc         , Xuc         , Xuc         , Xuc         
Ss          , Ss          , Ss          , Ss          , Ss          , Ss          , Ss          , Wwg         , Ss          , Wwg         , Wwg         , Ww          , Ww          , Ww          , Ds          , Ds          , Xuc         , Xuc         , Xuc         , Xuc         , Xuc         , Xuc         , Xuc         , Xuc         , Xuc         , Xuc         , Xuc         , Xuc         , Xuc         , Xuc         , Xuc         , Xuc         , Xuc         , Xuc         , Xuc         , Xuc         , Xuc         , Xuc         
